month,airline_id,unique_carrier,carrier,carrier_name,carrier_group_new,sdomt_gallons,satl_gallons,spac_gallons,slat_gallons,sint_gallons,ts_gallons,tdomt_gallons,tint_gallons,total_gallons,sdomt_cost,satl_cost,spac_cost,slat_cost,sint_cost,ts_cost,tdomt_cost,tint_cost,total_cost,year
1,,,0JQ,,1,0,0,0,0,0,0,3000,0,3000,0,0,0,0,0,0,5100,0,5100,2016
1,21352,0WQ,0WQ,Avjet Corporation,1,0,0,0,0,0,0,163052,47060,210112,0,0,0,0,0,0,396216,140239,536455,2016
1,21645,23Q,23Q,Songbird Airways Inc.,1,0,0,0,0,0,0,0,0,0,0,0,0,0,0,0,0,0,0,2016
1,21652,27Q,27Q,"Jet Aviation Flight Services, Inc.",1,0,0,0,0,0,0,0,0,0,0,0,0,0,0,0,0,0,0,2016
1,20408,5V,5V,Tatonduk Outfitters Limited d/b/a Everts Air Alaska and Everts Air Cargo,1,260848,0,0,0,0,260848,284362,0,284362,522405,0,0,0,0,522405,569497,0,569497,2016
1,19917,5X,5X,United Parcel Service,3,32138000,9743000,16116000,2972000,28831000,60969000,32138000,28831000,60969000,34098000,9752000,17965000,3524000,31241000,65339000,34098000,31241000,65339000,2016
1,20007,5Y,5Y,Atlas Air Inc.,3,0,0,0,0,0,0,4850893,19958297,24809190,0,0,0,0,0,0,8575368,35795479,44370847,2016
1,19874,8C,8C,Air Transport International,2,0,0,0,0,0,0,24211,725041,749252,0,0,0,0,0,0,42347,1855154,1897501,2016
1,20363,9E,9E,Endeavor Air Inc.,2,0,0,0,0,0,0,0,0,0,0,0,0,0,0,0,0,0,0,2016
1,20190,9S,9S,Southern Air Inc.,2,821638,4696010,580875,0,5276885,6098523,821638,5276885,6098523,1725440,9861621,1219839,0,11081460,12806900,1725440,11081460,12806900,2016
1,19805,AA,AA,American Airlines Inc.,3,174110023,34804210,18848029,54176666,107828905,281938928,174766325,107982308,282748633,195098544,34536551,18632951,68174028,121343530,316442074,195806362,121537723,317344085,2016
1,20453,ABX,ABX,ABX Air Inc,2,193054,0,0,0,0,193054,193054,0,193054,461092,0,0,0,0,461092,461092,0,461092,2016
1,19930,AS,AS,Alaska Airlines Inc.,3,36507433,0,0,1070108,1070108,37577541,36597369,1070108,37667477,45727266,0,0,1324811,1324811,47052077,45827760,1324811,47152571,2016
1,20409,B6,B6,JetBlue Airways,3,48414077,0,0,12141747,12141747,60555824,48414077,12209631,60623708,56262137,0,0,14109959,14109959,70372096,56262137,14275362,70537499,2016
1,21167,CP,CP,Compass Airlines,2,0,0,0,0,0,0,0,0,0,0,0,0,0,0,0,0,0,0,2016
1,19790,DL,DL,Delta Air Lines Inc.,3,137682215,51147892,38502896,30606142,120256930,257939145,139317615,120833633,260151248,187259219,69565371,52367129,41626889,163559389,350818608,190375249,164343753,354719002,2016
1,21650,EE,EE,Eastern Airlines Group Inc.,1,0,0,0,0,0,0,153520,221520,375040,0,0,0,0,0,0,202646,292406,495052,2016
1,20366,EV,EV,ExpressJet Airlines Inc.,3,81827,0,0,0,0,81827,81827,0,81827,159104,0,0,0,0,159104,159104,0,159104,2016
1,20436,F9,F9,Frontier Airlines Inc.,3,14431035,0,0,1659053,1659053,16090088,14496478,1659053,16155531,14466443,0,0,1912704,1912704,16379147,14532960,1912704,16445664,2016
1,20107,FX,FX,Federal Express Corporation,3,56549784,11101514,18643661,898730,30643905,87193689,57475790,31238131,88713921,58229000,12100000,22567000,1246000,35913000,94142000,59236000,37262000,96498000,2016
1,20368,G4,G4,Allegiant Air,3,11716758,0,0,0,0,11716758,12264170,0,12264170,14906048,0,0,0,0,14906048,15650180,0,15650180,2016
1,20500,G7,G7,GoJet Airlines LLC d/b/a United Express,2,0,0,0,0,0,0,0,0,0,0,0,0,0,0,0,0,0,0,2016
1,20166,GFQ,GFQ,Gulf And Caribbean Cargo,1,0,0,0,0,0,0,58531,73029,131560,0,0,0,0,0,0,87972,123487,211459,2016
1,20402,GL,GL,Miami Air International,2,0,0,0,0,0,0,471222,214746,685968,0,0,0,0,0,0,857483,390776,1248259,2016
1,19690,HA,HA,Hawaiian Airlines Inc.,3,13941595,0,5999327,0,5999327,19940922,13941595,6025122,19966717,15802368,0,7402409,0,7402409,23204777,15802368,7439636,23242004,2016
1,20310,WL,K8,"Caribbean Sun Airlines, Inc. d/b/a World Atlantic Airlines",1,0,0,0,0,0,0,48403,40699,89102,0,0,0,0,0,0,123588,103917,227505,2016
1,20370,KAQ,KAQ,Kalitta Air LLC,2,0,0,0,0,0,0,410148,3050479,3460627,0,0,0,0,0,0,611545,4869792,5481337,2016
1,21629,KD,KD,Western Global,1,0,0,0,0,0,0,0,0,0,0,0,0,0,0,0,0,0,0,2016
1,21634,KH,KH,Aloha Air Cargo,1,413456,0,0,0,0,413456,413456,0,413456,434504,0,0,0,0,434504,434504,0,434504,2016
1,20372,KLQ,KLQ,Kalitta Charters II,1,0,0,0,0,0,0,109805,27841,137646,0,0,0,0,0,0,185000,53552,238552,2016
1,20169,L2,L2,Lynden Air Cargo Airlines,1,89510,0,0,0,0,89510,186910,65872,252782,161258,0,0,0,0,161258,367368,22949,390317,2016
1,20151,M6,M6,Amerijet International,2,0,0,0,1430179,1430179,1430179,272239,1519209,1791448,0,0,0,1749260,1749260,1749260,332977,1858153,2191130,2016
1,20398,MQ,MQ,Envoy Air,3,0,0,0,0,0,0,0,0,0,0,0,0,0,0,0,0,0,0,2016
1,20405,N8,N8,National Air Cargo Group Inc d/ba National Airlines,1,83122,0,0,0,0,83122,137248,638661,775909,115124,0,0,0,0,115124,189081,1308431,1497512,2016
1,20108,NC,NC,Northern Air Cargo Inc.,1,330685,0,0,0,0,330685,434377,12514,446891,436594,0,0,0,0,436594,593187,19148,612335,2016
1,20416,NK,NK,Spirit Air Lines,3,21470845,0,0,2045962,2045962,23516807,21470845,2045962,23516807,26708498,0,0,2545059,2545059,29253557,26708498,2545059,29253557,2016
1,20397,OH,OH,PSA Airlines Inc.,2,0,0,0,0,0,0,0,0,0,0,0,0,0,0,0,0,0,0,2016
1,20304,OO,OO,SkyWest Airlines Inc.,3,5444514,0,0,0,0,5444514,5444514,0,5444514,8161174,0,0,0,0,8161174,8161174,0,8161174,2016
1,20177,PFQ,PFQ,Asia Pacific,1,0,0,0,0,0,0,0,273735,273735,0,0,0,0,0,0,0,512160,512160,2016
1,20100,PO,PO,Polar Air Cargo Airways,3,2743245,732505,11340447,0,12072952,14816197,2743245,12072952,14816197,3475089,1137597,13613593,0,14751190,18226279,3475089,14751190,18226279,2016
1,20149,PRQ,PRQ,Florida West Airlines Inc.,1,0,0,0,0,0,0,0,0,0,0,0,0,0,0,0,0,0,0,2016
1,19687,QX,QX,Horizon Air,2,0,0,0,0,0,0,0,0,0,0,0,0,0,0,0,0,0,0,2016
1,20448,S5,S5,Shuttle America Corp.,2,3793819,0,0,0,0,3793819,3793819,0,3793819,3841009,0,0,0,0,3841009,3841009,0,3841009,2016
1,20422,SY,SY,Sun Country Airlines d/b/a MN Airlines,2,2960736,0,0,1785889,1785889,4746625,3278155,1902325,5180480,3610049,0,0,2309531,2309531,5919580,4337385,2485305,6822690,2016
1,20447,U7,U7,USA Jet Airlines Inc.,2,0,0,0,0,0,0,222925,8289,231214,0,0,0,0,0,0,262237,15708,277945,2016
1,19977,UA,UA,United Air Lines Inc.,3,105832738,49571536,53863397,29504788,132939721,238772459,106816177,133413618,240229795,116933634,57361049,65397671,36006770,158765490,275699124,118320230,159405790,277726020,2016
1,21171,VX,VX,Virgin America,3,13914216,0,0,208163,208163,14122379,13986522,208163,14194685,15933654,0,0,252429,252429,16186083,16027319,252429,16279748,2016
1,20308,WE,WE,Centurion Cargo Inc.,2,0,0,0,0,0,0,0,449711,449711,0,0,0,0,0,0,0,537169,537169,2016
1,20195,WI,WI,Sky Lease Cargo,1,0,0,0,0,0,0,0,0,0,0,0,0,0,0,0,0,0,0,2016
1,20287,WP,WP,Island Air Hawaii,1,97142,0,0,0,0,97142,97142,0,97142,116920,0,0,0,0,116920,116920,0,116920,2016
1,20377,X9,X9,Omni Air Express,2,0,0,0,0,0,0,427170,2334415,2761585,0,0,0,0,0,0,717850,7200582,7918432,2016
1,20207,XP,XP,XTRA Airways,1,0,0,0,0,0,0,290899,468922,759821,0,0,0,0,0,0,494418,796989,1291407,2016
1,20378,YV,YV,Mesa Airlines Inc.,2,0,0,0,0,0,0,0,0,0,0,0,0,0,0,0,0,0,0,2016
1,20452,YX,YX,Republic Airlines,2,12732476,0,0,0,0,12732476,12732476,0,12732476,14986287,0,0,0,0,14986287,14986287,0,14986287,2016
1,20046,ZW,ZW,Air Wisconsin Airlines Corp,2,6016332,0,0,0,0,6016332,6016332,0,6016332,7953100,0,0,0,0,7953100,7953100,0,7953100,2016
1,19393,WN,WN,Southwest Airlines Co.,3,152934872,0,0,1247049,1247049,154181921,153259159,1247049,154506208,275515401,0,0,1771696,1771696,277287097,275939739,1771696,277711435,2016
2,21161,09Q,09Q,"Swift Air, LLC",1,0,0,0,0,0,0,218800,109897,328697,0,0,0,0,0,0,446977,226228,673205,2016
2,21352,0WQ,0WQ,Avjet Corporation,1,0,0,0,0,0,0,128194,53313,181507,0,0,0,0,0,0,330741,135415,466156,2016
2,21492,1BQ,1BQ,"Dynamic Airways, LLC",1,0,0,0,0,0,0,0,0,0,0,0,0,0,0,0,0,0,0,2016
2,21645,23Q,23Q,Songbird Airways Inc.,1,0,0,0,0,0,0,0,0,0,0,0,0,0,0,0,0,0,0,2016
2,21652,27Q,27Q,"Jet Aviation Flight Services, Inc.",1,0,0,0,0,0,0,0,0,0,0,0,0,0,0,0,0,0,0,2016
2,20408,5V,5V,Tatonduk Outfitters Limited d/b/a Everts Air Alaska and Everts Air Cargo,1,259422,0,0,0,0,259422,287095,0,287095,559804,0,0,0,0,559804,619519,0,619519,2016
2,19917,5X,5X,United Parcel Service,3,31170000,8611000,11634000,3087000,23332000,54502000,31170000,23332000,54502000,32449000,7650000,11412000,3576000,22638000,55087000,32449000,22638000,55087000,2016
2,20007,5Y,5Y,Atlas Air Inc.,3,0,0,0,0,0,0,4697494,20528784,25226278,0,0,0,0,0,0,8482313,35957109,44439422,2016
2,19874,8C,8C,Air Transport International,2,0,0,0,0,0,0,18695,658357,677052,0,0,0,0,0,0,36038,1809220,1845258,2016
2,20363,9E,9E,Endeavor Air Inc.,2,0,0,0,0,0,0,0,0,0,0,0,0,0,0,0,0,0,0,2016
2,20190,9S,9S,Southern Air Inc.,2,749638,3698889,480116,0,4179005,4928643,749638,4179005,4928643,1574240,7767667,1008243,0,8775910,10350150,1574240,8775910,10350150,2016
2,19805,AA,AA,American Airlines Inc.,3,167496992,32224150,18017131,48535743,98777024,266274016,167962196,98898820,266861016,177570624,29792404,15003646,58429066,103225116,280795740,178053556,103356830,281410386,2016
2,20453,ABX,ABX,ABX Air Inc,2,252917,0,0,0,0,252917,252917,0,252917,554065,0,0,0,0,554065,554065,0,554065,2016
2,19930,AS,AS,Alaska Airlines Inc.,3,34568885,0,0,893914,893914,35462799,34637580,893914,35531494,41003780,0,0,1094856,1094856,42098636,41076457,1094856,42171313,2016
2,20409,B6,B6,JetBlue Airways,3,47006545,0,0,11086304,11086304,58092849,47006545,11145308,58151853,53522617,0,0,12623093,12623093,66145710,53522617,12817678,66340295,2016
2,21167,CP,CP,Compass Airlines,2,0,0,0,0,0,0,0,0,0,0,0,0,0,0,0,0,0,0,2016
2,19790,DL,DL,Delta Air Lines Inc.,3,135851152,44443458,34079839,28138037,106661334,242512486,137448608,107216726,244665334,182052595,59558176,45670008,37707466,142935650,324988245,185127672,143679924,328807596,2016
2,21650,EE,EE,Eastern Airlines Group Inc.,1,0,0,0,0,0,0,228160,163200,391360,0,0,0,0,0,0,314861,225216,540077,2016
2,20366,EV,EV,ExpressJet Airlines Inc.,3,76666,0,0,0,0,76666,76666,0,76666,178088,0,0,0,0,178088,178088,0,178088,2016
2,20436,F9,F9,Frontier Airlines Inc.,3,13579962,0,0,1548775,1548775,15128737,13691848,1548775,15240623,13018168,0,0,1822358,1822358,14840526,13114789,1822358,14937147,2016
2,20107,FX,FX,Federal Express Corporation,3,54914562,11158508,16078750,519924,27757182,82671744,55821380,28466779,84288159,56401000,11706000,16857000,690000,29253000,85654000,57371000,30613000,87984000,2016
2,20368,G4,G4,Allegiant Air,3,12349401,0,0,0,0,12349401,12815963,0,12815963,15426891,0,0,0,0,15426891,16053275,0,16053275,2016
2,20500,G7,G7,GoJet Airlines LLC d/b/a United Express,2,0,0,0,0,0,0,0,0,0,0,0,0,0,0,0,0,0,0,2016
2,20166,GFQ,GFQ,Gulf And Caribbean Cargo,1,0,0,0,0,0,0,55553,74458,130011,0,0,0,0,0,0,89545,131663,221208,2016
2,20402,GL,GL,Miami Air International,2,0,0,0,0,0,0,385097,281349,666446,0,0,0,0,0,0,671224,490390,1161614,2016
2,19690,HA,HA,Hawaiian Airlines Inc.,3,12947588,0,5233178,0,5233178,18180766,12947588,5233178,18180766,14132312,0,5897859,0,5897859,20030171,14132312,5897859,20030171,2016
2,20310,WL,K8,"Caribbean Sun Airlines, Inc. d/b/a World Atlantic Airlines",1,0,0,0,0,0,0,36971,0,36971,0,0,0,0,0,0,93306,0,93306,2016
2,20370,KAQ,KAQ,Kalitta Air LLC,2,0,0,0,0,0,0,403246,2407946,2811192,0,0,0,0,0,0,545999,3697299,4243298,2016
2,21629,KD,KD,Western Global,1,0,0,0,0,0,0,18351,0,18351,0,0,0,0,0,0,18351,0,18351,2016
2,21634,KH,KH,Aloha Air Cargo,1,412808,0,0,0,0,412808,412808,0,412808,427991,0,0,0,0,427991,427991,0,427991,2016
2,20372,KLQ,KLQ,Kalitta Charters II,1,0,0,0,0,0,0,80604,13933,94537,0,0,0,0,0,0,152685,22077,174762,2016
2,20169,L2,L2,Lynden Air Cargo Airlines,1,79587,0,0,0,0,79587,150677,48423,199100,118835,0,0,0,0,118835,264940,31009,295949,2016
2,20151,M6,M6,Amerijet International,2,0,0,0,1531692,1531692,1531692,256209,1531692,1787901,0,0,0,1879064,1879064,1879064,314315,1879064,2193379,2016
2,20398,MQ,MQ,Envoy Air,3,0,0,0,0,0,0,0,0,0,0,0,0,0,0,0,0,0,0,2016
2,20405,N8,N8,National Air Cargo Group Inc d/ba National Airlines,1,124059,0,0,0,0,124059,174228,832108,1006336,162602,0,0,0,0,162602,228590,1702990,1931580,2016
2,20108,NC,NC,Northern Air Cargo Inc.,1,317290,0,0,0,0,317290,368420,9476,377896,414356,0,0,0,0,414356,472561,16019,488580,2016
2,20416,NK,NK,Spirit Air Lines,3,19937150,0,0,2044272,2044272,21981422,19937150,2044272,21981422,23485111,0,0,2408065,2408065,25893176,23485111,2408065,25893176,2016
2,20397,OH,OH,PSA Airlines Inc.,2,0,0,0,0,0,0,0,0,0,0,0,0,0,0,0,0,0,0,2016
2,20304,OO,OO,SkyWest Airlines Inc.,3,5287524,0,0,0,0,5287524,5287524,0,5287524,7860757,0,0,0,0,7860757,7860757,0,7860757,2016
2,20177,PFQ,PFQ,Asia Pacific,1,0,0,0,0,0,0,0,245619,245619,0,0,0,0,0,0,0,412422,412422,2016
2,20100,PO,PO,Polar Air Cargo Airways,3,2202955,624770,8971167,0,9595937,11798892,2202955,9595937,11798892,2449532,926752,9021672,0,9948424,12397956,2449532,9948424,12397956,2016
2,20149,PRQ,PRQ,Florida West Airlines Inc.,1,0,0,0,0,0,0,0,0,0,0,0,0,0,0,0,0,0,0,2016
2,19687,QX,QX,Horizon Air,2,0,0,0,0,0,0,0,0,0,0,0,0,0,0,0,0,0,0,2016
2,20448,S5,S5,Shuttle America Corp.,2,3082947,0,0,0,0,3082947,3082947,0,3082947,3177980,0,0,0,0,3177980,3177980,0,3177980,2016
2,20422,SY,SY,Sun Country Airlines d/b/a MN Airlines,2,2603490,0,0,2250440,2250440,4853930,2821924,2392845,5214769,3169810,0,0,2876159,2876159,6045969,3895757,3087377,6983134,2016
2,20447,U7,U7,USA Jet Airlines Inc.,2,0,0,0,0,0,0,305977,15967,321944,0,0,0,0,0,0,362231,27656,389887,2016
2,19977,UA,UA,United Air Lines Inc.,3,104234102,46493514,48804557,27809548,123107619,227341721,105058237,123584458,228642695,108637182,48480136,51598858,31604230,131683224,240320406,110006862,132212795,242219657,2016
2,21171,VX,VX,Virgin America,3,13185878,0,0,155185,155185,13341063,13261960,155185,13417145,13508081,0,0,186349,186349,13694430,13603946,186349,13790295,2016
2,20308,WE,WE,Centurion Cargo Inc.,2,0,0,0,0,0,0,0,119072,119072,0,0,0,0,0,0,0,137952,137952,2016
2,20195,WI,WI,Sky Lease Cargo,1,0,0,0,0,0,0,0,0,0,0,0,0,0,0,0,0,0,0,2016
2,20287,WP,WP,Island Air Hawaii,1,92320,0,0,0,0,92320,92320,0,92320,87273,0,0,0,0,87273,87273,0,87273,2016
2,20377,X9,X9,Omni Air Express,2,0,0,0,0,0,0,367356,2653968,3021324,0,0,0,0,0,0,519998,6964140,7484138,2016
2,20207,XP,XP,XTRA Airways,1,0,0,0,0,0,0,271433,400912,672345,0,0,0,0,0,0,445656,658243,1103899,2016
2,20378,YV,YV,Mesa Airlines Inc.,2,0,0,0,0,0,0,0,0,0,0,0,0,0,0,0,0,0,0,2016
2,20452,YX,YX,Republic Airlines,2,11730250,0,0,0,0,11730250,11730250,0,11730250,11499270,0,0,0,0,11499270,11499270,0,11499270,2016
2,20046,ZW,ZW,Air Wisconsin Airlines Corp,2,5867191,0,0,0,0,5867191,5867191,0,5867191,6239743,0,0,0,0,6239743,6239743,0,6239743,2016
2,19393,WN,WN,Southwest Airlines Co.,3,144331404,0,0,1162877,1162877,145494281,144524666,1162877,145687543,251263887,0,0,1624095,1624095,252887982,251480263,1624095,253104358,2016
3,21161,09Q,09Q,"Swift Air, LLC",1,0,0,0,0,0,0,388099,163060,551159,0,0,0,0,0,0,975347,300935,1276282,2016
3,21352,0WQ,0WQ,Avjet Corporation,1,0,0,0,0,0,0,12505,0,12505,0,0,0,0,0,0,32637,0,32637,2016
3,21492,1BQ,1BQ,"Dynamic Airways, LLC",1,0,0,0,0,0,0,0,0,0,0,0,0,0,0,0,0,0,0,2016
3,21645,23Q,23Q,Songbird Airways Inc.,1,0,0,0,0,0,0,0,0,0,0,0,0,0,0,0,0,0,0,2016
3,21652,27Q,27Q,"Jet Aviation Flight Services, Inc.",1,0,0,0,0,0,0,0,0,0,0,0,0,0,0,0,0,0,0,2016
3,20408,5V,5V,Tatonduk Outfitters Limited d/b/a Everts Air Alaska and Everts Air Cargo,1,280738,0,0,0,0,280738,368114,0,368114,621734,0,0,0,0,621734,815240,0,815240,2016
3,19917,5X,5X,United Parcel Service,3,35333000,10347000,16328000,3019000,29694000,65027000,35333000,29694000,65027000,39981000,10288000,17684000,3603000,31575000,71556000,39981000,31575000,71556000,2016
3,20007,5Y,5Y,Atlas Air Inc.,3,0,0,0,0,0,0,5339379,23449998,28789377,0,0,0,0,0,0,9763777,41179630,50943407,2016
3,19874,8C,8C,Air Transport International,2,0,0,0,0,0,0,5098,671367,676465,0,0,0,0,0,0,6186,1797260,1803446,2016
3,20363,9E,9E,Endeavor Air Inc.,2,0,0,0,0,0,0,0,0,0,0,0,0,0,0,0,0,0,0,2016
3,20190,9S,9S,Southern Air Inc.,2,1080693,4718620,703626,0,5422246,6502939,1080693,5422246,6502939,2269455,9909102,1477615,0,11386717,13656172,2269455,11386717,13656172,2016
3,19805,AA,AA,American Airlines Inc.,3,183558798,41951068,20040490,51377494,113369052,296927850,191902155,113639535,305541690,201270785,45290586,22083366,62789554,130163506,331434291,210086351,130500701,340587052,2016
3,20453,ABX,ABX,ABX Air Inc,2,312309,0,0,0,0,312309,312309,0,312309,590264,0,0,0,0,590264,590264,0,590264,2016
3,19930,AS,AS,Alaska Airlines Inc.,3,38491466,0,0,1033579,1033579,39525045,38563254,1033579,39596833,48927188,0,0,1338136,1338136,50265324,49007819,1338136,50345955,2016
3,20409,B6,B6,JetBlue Airways,3,52710801,0,0,11600896,11600896,64311697,52727049,11668072,64395121,63679453,0,0,14014940,14014940,77694393,63705743,14230732,77936475,2016
3,21167,CP,CP,Compass Airlines,2,0,0,0,0,0,0,0,0,0,0,0,0,0,0,0,0,0,0,2016
3,19790,DL,DL,Delta Air Lines Inc.,3,158268575,53179006,37683059,30162678,121024743,279293318,159812589,121163886,280976475,218289311,73346263,51973734,41601374,166921371,385210682,221359489,167113281,388472770,2016
3,21650,EE,EE,Eastern Airlines Group Inc.,1,0,0,0,0,0,0,279440,194480,473920,0,0,0,0,0,0,416366,289775,706141,2016
3,20366,EV,EV,ExpressJet Airlines Inc.,3,82715,0,0,0,0,82715,82715,0,82715,194962,0,0,0,0,194962,194962,0,194962,2016
3,20436,F9,F9,Frontier Airlines Inc.,3,14649706,0,0,1673457,1673457,16323163,14743364,1673457,16416821,15496557,0,0,2067749,2067749,17564306,15587483,2067749,17655232,2016
3,20107,FX,FX,Federal Express Corporation,3,64200341,12219228,19650854,545481,32415563,96615904,65327841,33159236,98487077,71032000,14057000,22714000,668000,37439000,108471000,72382000,38957000,111339000,2016
3,20368,G4,G4,Allegiant Air,3,15789297,0,0,0,0,15789297,16442818,0,16442818,21118263,0,0,0,0,21118263,22071234,0,22071234,2016
3,20500,G7,G7,GoJet Airlines LLC d/b/a United Express,2,0,0,0,0,0,0,0,0,0,0,0,0,0,0,0,0,0,0,2016
3,20166,GFQ,GFQ,Gulf And Caribbean Cargo,1,0,0,0,0,0,0,115405,111711,227116,0,0,0,0,0,0,181508,187163,368671,2016
3,20402,GL,GL,Miami Air International,2,0,0,0,0,0,0,468387,247328,715715,0,0,0,0,0,0,876352,462753,1339105,2016
3,19690,HA,HA,Hawaiian Airlines Inc.,3,14008850,0,5699264,0,5699264,19708114,14008850,5699264,19708114,16393085,0,6633860,0,6633860,23026945,16393085,6633860,23026945,2016
3,20310,WL,K8,"Caribbean Sun Airlines, Inc. d/b/a World Atlantic Airlines",1,0,0,0,0,0,0,48672,23926,72598,0,0,0,0,0,0,137262,67475,204737,2016
3,20370,KAQ,KAQ,Kalitta Air LLC,2,0,0,0,0,0,0,314683,2131944,2446627,0,0,0,0,0,0,537118,3605997,4143115,2016
3,21629,KD,KD,Western Global,1,0,0,0,0,0,0,40542,0,40542,0,0,0,0,0,0,40542,0,40542,2016
3,21634,KH,KH,Aloha Air Cargo,1,458733,0,0,0,0,458733,458733,0,458733,543848,0,0,0,0,543848,543848,0,543848,2016
3,20372,KLQ,KLQ,Kalitta Charters II,1,0,0,0,0,0,0,217766,35147,252913,0,0,0,0,0,0,398870,59049,457919,2016
3,20169,L2,L2,Lynden Air Cargo Airlines,1,114620,0,0,0,0,114620,206843,41440,248283,186487,0,0,0,0,186487,382815,0,382815,2016
3,20151,M6,M6,Amerijet International,2,0,0,0,1550644,1550644,1550644,255821,1550644,1806465,0,0,0,2019253,2019253,2019253,333131,2019253,2352384,2016
3,20398,MQ,MQ,Envoy Air,3,0,0,0,0,0,0,0,0,0,0,0,0,0,0,0,0,0,0,2016
3,20405,N8,N8,National Air Cargo Group Inc d/ba National Airlines,1,125772,0,0,0,0,125772,284788,492871,777659,175225,0,0,0,0,175225,408328,952076,1360404,2016
3,20108,NC,NC,Northern Air Cargo Inc.,1,338245,0,0,0,0,338245,404819,7566,412385,464156,0,0,0,0,464156,553876,13055,566931,2016
3,20416,NK,NK,Spirit Air Lines,3,18687532,0,0,1363468,1363468,20051000,18687532,1363468,20051000,28737098,0,0,2096698,2096698,30833796,28737098,2096698,30833796,2016
3,20397,OH,OH,PSA Airlines Inc.,2,0,0,0,0,0,0,0,0,0,0,0,0,0,0,0,0,0,0,2016
3,20304,OO,OO,SkyWest Airlines Inc.,3,6067876,0,0,0,0,6067876,6067876,0,6067876,8768054,0,0,0,0,8768054,8768054,0,8768054,2016
3,20177,PFQ,PFQ,Asia Pacific,1,0,0,0,0,0,0,0,273261,273261,0,0,0,0,0,0,0,439064,439064,2016
3,20100,PO,PO,Polar Air Cargo Airways,3,2859183,598747,12265181,0,12863928,15723111,2859183,12863928,15723111,3232286,1004931,13821928,0,14826859,18059145,3232286,14826859,18059145,2016
3,20149,PRQ,PRQ,Florida West Airlines Inc.,1,0,0,0,0,0,0,0,0,0,0,0,0,0,0,0,0,0,0,2016
3,19687,QX,QX,Horizon Air,2,0,0,0,0,0,0,0,0,0,0,0,0,0,0,0,0,0,0,2016
3,20448,S5,S5,Shuttle America Corp.,2,4370846,0,0,0,0,4370846,4370846,0,4370846,4851196,0,0,0,0,4851196,4851196,0,4851196,2016
3,20422,SY,SY,Sun Country Airlines d/b/a MN Airlines,2,2923994,0,0,2550642,2550642,5474636,3359333,2587415,5946748,3790053,0,0,3436691,3436691,7226744,4878371,3485150,8363521,2016
3,20447,U7,U7,USA Jet Airlines Inc.,2,0,0,0,0,0,0,553034,10707,563741,0,0,0,0,0,0,696187,19308,715495,2016
3,19977,UA,UA,United Air Lines Inc.,3,122317188,52529748,55012275,33779108,141321131,263638319,123516238,141821581,265337819,135860987,58368588,61767973,39892592,160029153,295890140,137362636,160602360,297964996,2016
3,21171,VX,VX,Virgin America,3,15183618,0,0,191967,191967,15375585,15268202,191967,15460169,17289517,0,0,245492,245492,17535009,17402265,245492,17647757,2016
3,20308,WE,WE,Centurion Cargo Inc.,2,0,0,0,0,0,0,0,0,0,0,0,0,0,0,0,0,0,0,2016
3,20195,WI,WI,Sky Lease Cargo,1,0,0,0,0,0,0,0,0,0,0,0,0,0,0,0,0,0,0,2016
3,20287,WP,WP,Island Air Hawaii,1,121341,0,0,0,0,121341,121341,0,121341,132902,0,0,0,0,132902,132902,0,132902,2016
3,20377,X9,X9,Omni Air Express,2,0,0,0,0,0,0,371469,1924209,2295678,0,0,0,0,0,0,739193,5089662,5828855,2016
3,20207,XP,XP,XTRA Airways,1,0,0,0,0,0,0,350091,500391,850482,0,0,0,0,0,0,639529,914089,1553618,2016
3,20378,YV,YV,Mesa Airlines Inc.,2,0,0,0,0,0,0,0,0,0,0,0,0,0,0,0,0,0,0,2016
3,20452,YX,YX,Republic Airlines,2,13995700,0,0,0,0,13995700,13995700,0,13995700,15033057,0,0,0,0,15033057,15033057,0,15033057,2016
3,20046,ZW,ZW,Air Wisconsin Airlines Corp,2,6588736,0,0,0,0,6588736,6588736,0,6588736,7498977,0,0,0,0,7498977,7498977,0,7498977,2016
3,19393,WN,WN,Southwest Airlines Co.,3,170974112,0,0,1413391,1413391,172387503,171254232,1413391,172667623,281475503,0,0,2068733,2068733,283544236,281824146,2068733,283892879,2016
4,21161,09Q,09Q,"Swift Air, LLC",1,0,0,0,0,0,0,214900,164261,379161,0,0,0,0,0,0,555293,104139,659432,2016
4,21352,0WQ,0WQ,Avjet Corporation,1,0,0,0,0,0,0,18337,1761,20098,0,0,0,0,0,0,47189,5330,52519,2016
4,21492,1BQ,1BQ,"Dynamic Airways, LLC",1,0,0,0,0,0,0,0,0,0,0,0,0,0,0,0,0,0,0,2016
4,21645,23Q,23Q,Songbird Airways Inc.,1,0,0,0,0,0,0,0,0,0,0,0,0,0,0,0,0,0,0,2016
4,21652,27Q,27Q,"Jet Aviation Flight Services, Inc.",1,0,0,0,0,0,0,0,0,0,0,0,0,0,0,0,0,0,0,2016
4,20408,5V,5V,Tatonduk Outfitters Limited d/b/a Everts Air Alaska and Everts Air Cargo,1,286682,0,0,0,0,286682,343885,0,343885,594908,0,0,0,0,594908,713613,0,713613,2016
4,19917,5X,5X,United Parcel Service,3,31447000,9825000,15942000,3119000,28886000,60333000,31447000,28886000,60333000,37664000,10499000,19037000,3980000,33516000,71180000,37664000,33516000,71180000,2016
4,20007,5Y,5Y,Atlas Air Inc.,3,0,0,0,0,0,0,5636265,25239885,30876150,0,0,0,0,0,0,9484407,42794561,52278968,2016
4,19874,8C,8C,Air Transport International,2,0,0,0,0,0,0,15860,642249,658109,0,0,0,0,0,0,20003,1486137,1506140,2016
4,20363,9E,9E,Endeavor Air Inc.,2,0,0,0,0,0,0,0,0,0,0,0,0,0,0,0,0,0,0,2016
4,20190,9S,9S,Southern Air Inc.,2,843577,4627284,624131,0,5251415,6094992,843577,5251415,6094992,1771512,9717296,1310675,0,11027971,12799483,1771512,11027971,12799483,2016
4,19805,AA,AA,American Airlines Inc.,3,177707514,47894888,18686090,47112699,113693677,291401191,178399621,113855605,292255226,208343118,55606129,23078979,62886789,141571897,349915015,209148977,141781044,350930021,2016
4,20453,ABX,ABX,ABX Air Inc,2,161669,0,0,0,0,161669,161669,0,161669,320880,0,0,0,0,320880,320880,0,320880,2016
4,19930,AS,AS,Alaska Airlines Inc.,3,37646121,0,0,848713,848713,38494834,37750045,848713,38598758,50516139,0,0,1146056,1146056,51662195,50638870,1146056,51784926,2016
4,20409,B6,B6,JetBlue Airways,3,50680184,0,0,11672680,11672680,62352864,50689532,11739436,62428968,64364625,0,0,14824485,14824485,79189110,64391404,14997033,79388437,2016
4,21167,CP,CP,Compass Airlines,2,0,0,0,0,0,0,0,0,0,0,0,0,0,0,0,0,0,0,2016
4,19790,DL,DL,Delta Air Lines Inc.,3,149301057,62882427,38277762,27144323,128304512,277605569,150703885,128895534,279599419,228947019,96427610,58697370,41624701,196749681,425696700,231884029,197655991,429540020,2016
4,21650,EE,EE,Eastern Airlines Group Inc.,1,0,0,0,0,0,0,140560,177840,318400,0,0,0,0,0,0,217868,275652,493520,2016
4,20366,EV,EV,ExpressJet Airlines Inc.,3,77831,0,0,0,0,77831,77831,0,77831,220371,0,0,0,0,220371,220371,0,220371,2016
4,20436,F9,F9,Frontier Airlines Inc.,3,14715973,0,0,1283226,1283226,15999199,14788087,1283226,16071313,16416498,0,0,2275877,2275877,18692375,16496000,2275877,18771877,2016
4,20107,FX,FX,Federal Express Corporation,3,59540782,11764710,18618272,569807,30952789,90493571,60455074,31639930,92095004,69107000,14331000,23134000,716000,38181000,107288000,70245000,39474000,109719000,2016
4,20368,G4,G4,Allegiant Air,3,12903919,0,0,0,0,12903919,13408496,0,13408496,17867925,0,0,0,0,17867925,18602361,0,18602361,2016
4,20500,G7,G7,GoJet Airlines LLC d/b/a United Express,2,0,0,0,0,0,0,0,0,0,0,0,0,0,0,0,0,0,0,2016
4,20166,GFQ,GFQ,Gulf And Caribbean Cargo,1,0,0,0,0,0,0,97865,95895,193760,0,0,0,0,0,0,168586,178279,346865,2016
4,20402,GL,GL,Miami Air International,2,0,0,0,0,0,0,314277,256206,570483,0,0,0,0,0,0,573179,467268,1040447,2016
4,19690,HA,HA,Hawaiian Airlines Inc.,3,13260286,0,5672220,0,5672220,18932506,13260286,5672220,18932506,16175531,0,7048103,0,7048103,23223634,16175531,7048103,23223634,2016
4,20310,WL,K8,"Caribbean Sun Airlines, Inc. d/b/a World Atlantic Airlines",1,0,0,0,0,0,0,13671,28806,42477,0,0,0,0,0,0,26757,56379,83136,2016
4,20370,KAQ,KAQ,Kalitta Air LLC,2,0,0,0,0,0,0,419729,3231445,3651174,0,0,0,0,0,0,537977,5140462,5678439,2016
4,21629,KD,KD,Western Global,1,0,0,0,0,0,0,7812,0,7812,0,0,0,0,0,0,7812,0,7812,2016
4,21634,KH,KH,Aloha Air Cargo,1,417640,0,0,0,0,417640,417640,0,417640,518317,0,0,0,0,518317,518317,0,518317,2016
4,20372,KLQ,KLQ,Kalitta Charters II,1,0,0,0,0,0,0,144431,11771,156202,0,0,0,0,0,0,285107,21862,306969,2016
4,20169,L2,L2,Lynden Air Cargo Airlines,1,89681,0,0,0,0,89681,165702,30192,195894,143032,0,0,0,0,143032,310424,0,310424,2016
4,20151,M6,M6,Amerijet International,2,0,0,0,1549952,1549952,1549952,270803,1587668,1858471,0,0,0,2084311,2084311,2084311,364165,2135030,2499195,2016
4,20398,MQ,MQ,Envoy Air,3,0,0,0,0,0,0,0,0,0,0,0,0,0,0,0,0,0,0,2016
4,20405,N8,N8,National Air Cargo Group Inc d/ba National Airlines,1,127419,0,0,0,0,127419,253810,1135690,1389500,184237,0,0,0,0,184237,402044,2180812,2582856,2016
4,20108,NC,NC,Northern Air Cargo Inc.,1,356938,0,0,0,0,356938,456447,6658,463105,500491,0,0,0,0,500491,664220,11075,675295,2016
4,20416,NK,NK,Spirit Air Lines,3,22416916,0,0,2298537,2298537,24715453,22416916,2298537,24715453,29448637,0,0,3019541,3019541,32468178,29448637,3019541,32468178,2016
4,20397,OH,OH,PSA Airlines Inc.,2,0,0,0,0,0,0,0,0,0,0,0,0,0,0,0,0,0,0,2016
4,20304,OO,OO,SkyWest Airlines Inc.,3,6079389,0,0,0,0,6079389,6079389,0,6079389,9365067,0,0,0,0,9365067,9365067,0,9365067,2016
4,20177,PFQ,PFQ,Asia Pacific,1,0,0,0,0,0,0,0,283134,283134,0,0,0,0,0,0,0,504738,504738,2016
4,20100,PO,PO,Polar Air Cargo Airways,3,2857246,561171,11298773,0,11859944,14717190,2857246,11859944,14717190,3593983,926084,14053952,0,14980036,18574019,3593983,14980036,18574019,2016
4,20149,PRQ,PRQ,Florida West Airlines Inc.,1,0,0,0,0,0,0,0,0,0,0,0,0,0,0,0,0,0,0,2016
4,19687,QX,QX,Horizon Air,2,0,0,0,0,0,0,0,0,0,0,0,0,0,0,0,0,0,0,2016
4,20448,S5,S5,Shuttle America Corp.,2,2625542,0,0,0,0,2625542,2625542,0,2625542,3036717,0,0,0,0,3036717,3036717,0,3036717,2016
4,20422,SY,SY,Sun Country Airlines d/b/a MN Airlines,2,3309540,0,0,1110568,1110568,4420108,3627674,1202452,4830126,4466038,0,0,1540558,1540558,6006596,5259274,1669116,6928390,2016
4,20447,U7,U7,USA Jet Airlines Inc.,2,0,0,0,0,0,0,467078,14797,481875,0,0,0,0,0,0,607201,29328,636529,2016
4,19977,UA,UA,United Air Lines Inc.,3,117401789,58493491,51940830,27956864,138391185,255792974,118947354,138946043,257893397,136755009,69845045,64280279,34618623,168743947,305498956,139221625,169452879,308674504,2016
4,21171,VX,VX,Virgin America,3,15358393,0,0,221732,221732,15580125,15419080,221732,15640812,18009367,0,0,295351,295351,18304718,18089258,295351,18384609,2016
4,20308,WE,WE,Centurion Cargo Inc.,2,0,0,0,0,0,0,0,0,0,0,0,0,0,0,0,0,0,0,2016
4,20195,WI,WI,Sky Lease Cargo,1,0,0,0,0,0,0,0,0,0,0,0,0,0,0,0,0,0,0,2016
4,20287,WP,WP,Island Air Hawaii,1,126195,0,0,0,0,126195,126195,0,126195,160992,0,0,0,0,160992,160992,0,160992,2016
4,20377,X9,X9,Omni Air Express,2,0,0,0,0,0,0,313154,2564853,2878007,0,0,0,0,0,0,374541,5625344,5999885,2016
4,20207,XP,XP,XTRA Airways,1,0,0,0,0,0,0,255494,321858,577352,0,0,0,0,0,0,471922,594502,1066424,2016
4,20378,YV,YV,Mesa Airlines Inc.,2,0,0,0,0,0,0,0,0,0,0,0,0,0,0,0,0,0,0,2016
4,20452,YX,YX,Republic Airlines,2,12792878,0,0,0,0,12792878,12792878,0,12792878,14688177,0,0,0,0,14688177,14688177,0,14688177,2016
4,20046,ZW,ZW,Air Wisconsin Airlines Corp,2,6281133,0,0,0,0,6281133,6281133,0,6281133,7769570,0,0,0,0,7769570,7769570,0,7769570,2016
4,19393,WN,WN,Southwest Airlines Co.,3,164539419,0,0,1327766,1327766,165867185,164789814,1327766,166117580,260325526,0,0,2039632,2039632,262365158,260647957,2039632,262687589,2016
5,21161,09Q,09Q,"Swift Air, LLC",1,0,0,0,0,0,0,147140,171312,318452,0,0,0,0,0,0,333778,60518,394296,2016
5,21352,0WQ,0WQ,Avjet Corporation,1,0,0,0,0,0,0,23873,0,23873,0,0,0,0,0,0,67800,0,67800,2016
5,21492,1BQ,1BQ,"Dynamic Airways, LLC",1,0,0,0,0,0,0,0,34091,34091,0,0,0,0,0,0,0,543913,543913,2016
5,21645,23Q,23Q,Songbird Airways Inc.,1,0,0,0,0,0,0,0,0,0,0,0,0,0,0,0,0,0,0,2016
5,21652,27Q,27Q,"Jet Aviation Flight Services, Inc.",1,0,0,0,0,0,0,0,0,0,0,0,0,0,0,0,0,0,0,2016
5,20408,5V,5V,Tatonduk Outfitters Limited d/b/a Everts Air Alaska and Everts Air Cargo,1,271227,0,0,0,0,271227,338719,0,338719,635976,0,0,0,0,635976,794232,0,794232,2016
5,19917,5X,5X,United Parcel Service,3,32447000,10257000,15834000,2936000,29027000,61474000,32447000,29027000,61474000,43501000,11865000,20031000,4125000,36021000,79522000,43501000,36021000,79522000,2016
5,20007,5Y,5Y,Atlas Air Inc.,3,0,0,0,0,0,0,5949340,23684426,29633766,0,0,0,0,0,0,10497530,41483393,51980923,2016
5,19874,8C,8C,Air Transport International,2,0,0,0,0,0,0,33632,765779,799411,0,0,0,0,0,0,74205,1376816,1451021,2016
5,20363,9E,9E,Endeavor Air Inc.,2,0,0,0,0,0,0,0,0,0,0,0,0,0,0,0,0,0,0,2016
5,20190,9S,9S,Southern Air Inc.,2,842946,4858727,605881,0,5464608,6307554,842946,5464608,6307554,1770186,10203327,1272350,0,11475677,13245863,1770186,11475677,13245863,2016
5,19805,AA,AA,American Airlines Inc.,3,188173263,58916742,20611331,44721899,124249972,312423235,188798331,124391797,313190128,240806331,73473775,28095511,64461571,166030857,406837188,241602609,166222348,407824957,2016
5,20453,ABX,ABX,ABX Air Inc,2,74254,0,0,0,0,74254,74254,0,74254,140340,0,0,0,0,140340,140340,0,140340,2016
5,19930,AS,AS,Alaska Airlines Inc.,3,38530118,0,0,529587,529587,39059705,38602533,529587,39132120,56825913,0,0,816310,816310,57642223,56921331,816310,57737641,2016
5,20409,B6,B6,JetBlue Airways,3,52143067,0,0,11341609,11341609,63484676,52143067,11406517,63549584,75222091,0,0,16361515,16361515,91583606,75222091,16567565,91789656,2016
5,21167,CP,CP,Compass Airlines,2,0,0,0,0,0,0,0,0,0,0,0,0,0,0,0,0,0,0,2016
5,19790,DL,DL,Delta Air Lines Inc.,3,166393090,67736146,38384410,25675594,131796150,298189240,167433775,131994673,299428448,250667883,102043158,57825351,38679772,198548281,449216164,253282613,198847352,452129965,2016
5,21650,EE,EE,Eastern Airlines Group Inc.,1,0,0,0,0,0,0,80560,228400,308960,0,0,0,0,0,0,136952,388280,525232,2016
5,20366,EV,EV,ExpressJet Airlines Inc.,3,85605,0,0,0,0,85605,85605,0,85605,198677,0,0,0,0,198677,198677,0,198677,2016
5,20436,F9,F9,Frontier Airlines Inc.,3,16112239,0,0,1058525,1058525,17170764,16116093,1058525,17174618,20958141,0,0,1458918,1458918,22417059,20963972,1458918,22422890,2016
5,20107,FX,FX,Federal Express Corporation,3,56958675,10623566,19110011,1348679,31082256,88040931,57865369,31650098,89515467,74636000,14434000,25254000,1883000,41571000,116207000,75880000,42593000,118473000,2016
5,20368,G4,G4,Allegiant Air,3,13020287,0,0,0,0,13020287,13615505,0,13615505,20090419,0,0,0,0,20090419,21056684,0,21056684,2016
5,20500,G7,G7,GoJet Airlines LLC d/b/a United Express,2,0,0,0,0,0,0,0,0,0,0,0,0,0,0,0,0,0,0,2016
5,20166,GFQ,GFQ,Gulf And Caribbean Cargo,1,0,0,0,0,0,0,149455,69425,218880,0,0,0,0,0,0,276594,136710,413304,2016
5,20402,GL,GL,Miami Air International,2,0,0,0,0,0,0,257807,280637,538444,0,0,0,0,0,0,488106,531330,1019436,2016
5,19690,HA,HA,Hawaiian Airlines Inc.,3,13924977,0,5744440,0,5744440,19669417,13924977,5744440,19669417,18714545,0,7652234,0,7652234,26366779,18714545,7652234,26366779,2016
5,20310,WL,K8,"Caribbean Sun Airlines, Inc. d/b/a World Atlantic Airlines",1,0,0,0,0,0,0,38284,21030,59314,0,0,0,0,0,0,99177,54479,153656,2016
5,20370,KAQ,KAQ,Kalitta Air LLC,2,0,0,0,0,0,0,197426,1872617,2070043,0,0,0,0,0,0,310221,3104412,3414633,2016
5,21629,KD,KD,Western Global,1,0,0,0,0,0,0,14921,0,14921,0,0,0,0,0,0,14921,0,14921,2016
5,21634,KH,KH,Aloha Air Cargo,1,420758,0,0,0,0,420758,420758,0,420758,575838,0,0,0,0,575838,575838,0,575838,2016
5,20372,KLQ,KLQ,Kalitta Charters II,1,0,0,0,0,0,0,223726,11838,235564,0,0,0,0,0,0,463663,27270,490933,2016
5,20169,L2,L2,Lynden Air Cargo Airlines,1,70036,0,0,0,0,70036,160638,79572,240210,154260,0,0,0,0,154260,378881,56322,435203,2016
5,20151,M6,M6,Amerijet International,2,0,0,0,1533671,1533671,1533671,226194,1533671,1759865,0,0,0,2317136,2317136,2317136,341744,2317136,2658880,2016
5,20398,MQ,MQ,Envoy Air,3,0,0,0,0,0,0,0,0,0,0,0,0,0,0,0,0,0,0,2016
5,20405,N8,N8,National Air Cargo Group Inc d/ba National Airlines,1,108059,0,0,0,0,108059,159152,507514,666666,177226,0,0,0,0,177226,263413,923933,1187346,2016
5,20108,NC,NC,Northern Air Cargo Inc.,1,361043,0,0,0,0,361043,446423,20519,466942,558044,0,0,0,0,558044,703749,37146,740895,2016
5,20416,NK,NK,Spirit Air Lines,3,23984200,0,0,2430117,2430117,26414317,23984200,2430117,26414317,35808103,0,0,3628134,3628134,39436237,35808103,3628134,39436237,2016
5,20397,OH,OH,PSA Airlines Inc.,2,0,0,0,0,0,0,0,0,0,0,0,0,0,0,0,0,0,0,2016
5,20304,OO,OO,SkyWest Airlines Inc.,3,6375164,0,0,0,0,6375164,6375164,0,6375164,10830449,0,0,0,0,10830449,10830449,0,10830449,2016
5,20177,PFQ,PFQ,Asia Pacific,1,0,0,0,0,0,0,0,297367,297367,0,0,0,0,0,0,0,576633,576633,2016
5,20100,PO,PO,Polar Air Cargo Airways,3,2874850,739594,11963689,0,12703283,15578133,2874850,12703283,15578133,3955164,1268358,15843462,0,17111820,21066984,3955164,17111820,21066984,2016
5,20149,PRQ,PRQ,Florida West Airlines Inc.,1,0,0,0,0,0,0,0,0,0,0,0,0,0,0,0,0,0,0,2016
5,19687,QX,QX,Horizon Air,2,0,0,0,0,0,0,0,0,0,0,0,0,0,0,0,0,0,0,2016
5,20448,S5,S5,Shuttle America Corp.,2,2922167,0,0,0,0,2922167,2922167,0,2922167,3854389,0,0,0,0,3854389,3854389,0,3854389,2016
5,20422,SY,SY,Sun Country Airlines d/b/a MN Airlines,2,3204217,0,0,315818,315818,3520035,3484679,336968,3821647,4759757,0,0,506000,506000,5265757,5621805,536323,6158128,2016
5,20447,U7,U7,USA Jet Airlines Inc.,2,0,0,0,0,0,0,442592,16964,459556,0,0,0,0,0,0,641758,33143,674901,2016
5,19977,UA,UA,United Air Lines Inc.,3,128089752,71337902,55163615,25271415,151772932,279862684,129102217,152292687,281394904,166748398,93926667,73440020,34357490,201724177,368472575,168346615,202483949,370830564,2016
5,21171,VX,VX,Virgin America,3,16103102,0,0,225016,225016,16328118,16189161,225016,16414177,21275606,0,0,340315,340315,21615921,21397134,340315,21737449,2016
5,20308,WE,WE,Centurion Cargo Inc.,2,0,0,0,0,0,0,0,329399,329399,0,0,0,0,0,0,0,503652,503652,2016
5,20195,WI,WI,Sky Lease Cargo,1,0,0,0,0,0,0,0,0,0,0,0,0,0,0,0,0,0,0,2016
5,20287,WP,WP,Island Air Hawaii,1,128211,0,0,0,0,128211,128211,0,128211,177108,0,0,0,0,177108,177108,0,177108,2016
5,20377,X9,X9,Omni Air Express,2,0,0,0,0,0,0,422869,1706503,2129372,0,0,0,0,0,0,699603,2184675,2884278,2016
5,20207,XP,XP,XTRA Airways,1,0,0,0,0,0,0,210506,345640,556146,0,0,0,0,0,0,406277,667085,1073362,2016
5,20378,YV,YV,Mesa Airlines Inc.,2,0,0,0,0,0,0,0,0,0,0,0,0,0,0,0,0,0,0,2016
5,20452,YX,YX,Republic Airlines,2,11820783,0,0,0,0,11820783,11820783,0,11820783,14889666,0,0,0,0,14889666,14889666,0,14889666,2016
5,20046,ZW,ZW,Air Wisconsin Airlines Corp,2,6510272,0,0,0,0,6510272,6510272,0,6510272,8792834,0,0,0,0,8792834,8792834,0,8792834,2016
5,19393,WN,WN,Southwest Airlines Co.,3,168521108,0,0,1559242,1559242,170080350,168730965,1559242,170290207,282700393,0,0,2523271,2523271,285223664,283000560,2523271,285523831,2016
6,21352,0WQ,0WQ,Avjet Corporation,1,0,0,0,0,0,0,26382,0,26382,0,0,0,0,0,0,82048,0,82048,2016
6,21492,1BQ,1BQ,"Dynamic Airways, LLC",1,0,0,0,0,0,0,0,0,0,0,0,0,0,0,0,0,0,0,2016
6,21645,23Q,23Q,Songbird Airways Inc.,1,0,0,0,0,0,0,0,0,0,0,0,0,0,0,0,0,0,0,2016
6,21652,27Q,27Q,"Jet Aviation Flight Services, Inc.",1,0,0,0,0,0,0,0,0,0,0,0,0,0,0,0,0,0,0,2016
6,20408,5V,5V,Tatonduk Outfitters Limited d/b/a Everts Air Alaska and Everts Air Cargo,1,302733,0,0,0,0,302733,398853,0,398853,755323,0,0,0,0,755323,995143,0,995143,2016
6,19917,5X,5X,United Parcel Service,3,34866000,10306000,16547000,2954000,29807000,64673000,34866000,29807000,64673000,51063000,13036000,23045000,4594000,40675000,91738000,51063000,40675000,91738000,2016
6,20007,5Y,5Y,Atlas Air Inc.,3,291215,23308,1000311,0,1023619,1314834,5897956,24256933,30154889,515608,41205,1435088,0,1476293,1991901,11084437,43093634,54178071,2016
6,19874,8C,8C,Air Transport International,2,0,0,0,0,0,0,40158,686934,727092,0,0,0,0,0,0,87049,1304397,1391446,2016
6,20363,9E,9E,Endeavor Air Inc.,2,0,0,0,0,0,0,0,0,0,0,0,0,0,0,0,0,0,0,2016
6,20190,9S,9S,Southern Air Inc.,2,738701,4855259,605727,0,5460986,6199687,738701,5460986,6199687,1551273,10196043,1272028,0,11468071,13019344,1551273,11468071,13019344,2016
6,19805,AA,AA,American Airlines Inc.,3,197906512,59292754,20218345,46968272,126479371,324385883,198543094,126669963,325213057,275326709,82197493,29385428,72237773,183820694,459147403,276199571,184107165,460306736,2016
6,20453,ABX,ABX,ABX Air Inc,2,41106,0,0,0,0,41106,41106,0,41106,68116,0,0,0,0,68116,68116,0,68116,2016
6,19930,AS,AS,Alaska Airlines Inc.,3,39625748,0,0,606009,606009,40231757,39737824,606009,40343833,64408200,0,0,1076111,1076111,65484311,64569458,1076111,65645569,2016
6,20409,B6,B6,JetBlue Airways,3,52913453,0,0,12348743,12348743,65262196,52913453,12410855,65324308,83355278,0,0,19453142,19453142,102808420,83355278,19598933,102954211,2016
6,21167,CP,CP,Compass Airlines,2,0,0,0,0,0,0,0,0,0,0,0,0,0,0,0,0,0,0,2016
6,19790,DL,DL,Delta Air Lines Inc.,3,172351051,75607542,38535385,25534288,139677215,312028266,173714766,139996846,313711612,529202429,232152313,118322571,78402812,428877696,958080125,533585511,429859120,963444631,2016
6,21650,EE,EE,Eastern Airlines Group Inc.,1,0,0,0,0,0,0,228640,255280,483920,0,0,0,0,0,0,388688,433976,822664,2016
6,20366,EV,EV,ExpressJet Airlines Inc.,3,80305,0,0,0,0,80305,80305,0,80305,204875,0,0,0,0,204875,204875,0,204875,2016
6,20436,F9,F9,Frontier Airlines Inc.,3,17354728,0,0,731210,731210,18085938,17359786,731210,18090996,23864883,0,0,1667992,1667992,25532875,23874936,1667992,25542928,2016
6,20107,FX,FX,Federal Express Corporation,3,60448722,10445803,18483971,1793749,30723523,91172245,61493610,30994871,92488481,87052000,15057000,26893000,2700000,44650000,131702000,88582000,45047000,133629000,2016
6,20368,G4,G4,Allegiant Air,3,16400386,0,0,0,0,16400386,17128733,0,17128733,27515866,0,0,0,0,27515866,28784055,0,28784055,2016
6,20500,G7,G7,GoJet Airlines LLC d/b/a United Express,2,0,0,0,0,0,0,0,0,0,0,0,0,0,0,0,0,0,0,2016
6,20166,GFQ,GFQ,Gulf And Caribbean Cargo,1,0,0,0,0,0,0,299168,145047,444215,0,0,0,0,0,0,582654,308850,891504,2016
6,20402,GL,GL,Miami Air International,2,0,0,0,0,0,0,377084,246977,624061,0,0,0,0,0,0,833506,545915,1379421,2016
6,19690,HA,HA,Hawaiian Airlines Inc.,3,15348068,0,5748099,0,5748099,21096167,15348068,5748099,21096167,22620137,0,8336573,0,8336573,30956710,22620137,8336573,30956710,2016
6,20310,WL,K8,"Caribbean Sun Airlines, Inc. d/b/a World Atlantic Airlines",1,0,0,0,0,0,0,28269,21940,50209,0,0,0,0,0,0,55523,43092,98615,2016
6,20370,KAQ,KAQ,Kalitta Air LLC,2,0,0,0,0,0,0,642251,1833191,2475442,0,0,0,0,0,0,974967,3124473,4099440,2016
6,21629,KD,KD,Western Global,1,0,0,0,0,0,0,132846,149186,282032,0,0,0,0,0,0,132846,149186,282032,2016
6,21634,KH,KH,Aloha Air Cargo,1,414878,0,0,0,0,414878,414878,0,414878,615846,0,0,0,0,615846,615846,0,615846,2016
6,20372,KLQ,KLQ,Kalitta Charters II,1,0,0,0,0,0,0,93080,33990,127070,0,0,0,0,0,0,193562,84524,278086,2016
6,20169,L2,L2,Lynden Air Cargo Airlines,1,79244,0,0,0,0,79244,190880,6977,197857,152023,0,0,0,0,152023,375717,17443,393160,2016
6,20151,M6,M6,Amerijet International,2,0,0,0,1610621,1610621,1610621,245940,1628979,1874919,0,0,0,2665437,2665437,2665437,407009,2695818,3102827,2016
6,20398,MQ,MQ,Envoy Air,3,0,0,0,0,0,0,0,0,0,0,0,0,0,0,0,0,0,0,2016
6,20405,N8,N8,National Air Cargo Group Inc d/ba National Airlines,1,56403,0,0,0,0,56403,209214,247808,457022,104383,0,0,0,0,104383,329849,466194,796043,2016
6,20108,NC,NC,Northern Air Cargo Inc.,1,436452,0,0,0,0,436452,558685,0,558685,845621,0,0,0,0,845621,1040758,0,1040758,2016
6,20416,NK,NK,Spirit Air Lines,3,23476382,0,0,2407170,2407170,25883552,23476382,2407170,25883552,37447534,0,0,3839714,3839714,41287248,37447534,3839714,41287248,2016
6,20397,OH,OH,PSA Airlines Inc.,2,0,0,0,0,0,0,0,0,0,0,0,0,0,0,0,0,0,0,2016
6,20304,OO,OO,SkyWest Airlines Inc.,3,6376531,0,0,0,0,6376531,6376531,0,6376531,11480104,0,0,0,0,11480104,11480104,0,11480104,2016
6,20177,PFQ,PFQ,Asia Pacific,1,0,0,0,0,0,0,0,280183,280183,0,0,0,0,0,0,0,505845,505845,2016
6,20100,PO,PO,Polar Air Cargo Airways,3,2793706,680350,11334159,0,12014509,14808215,2793706,12014509,14808215,4070029,1204147,16434199,0,17638346,21708375,4070029,17638346,21708375,2016
6,20149,PRQ,PRQ,Florida West Airlines Inc.,1,0,0,0,0,0,0,0,0,0,0,0,0,0,0,0,0,0,0,2016
6,19687,QX,QX,Horizon Air,2,0,0,0,0,0,0,0,0,0,0,0,0,0,0,0,0,0,0,2016
6,20448,S5,S5,Shuttle America Corp.,2,2974618,0,0,0,0,2974618,2974618,0,2974618,4340750,0,0,0,0,4340750,4340750,0,4340750,2016
6,20422,SY,SY,Sun Country Airlines d/b/a MN Airlines,2,3579146,0,0,602329,602329,4181475,4093831,606254,4700085,5800927,0,0,1085863,1085863,6886790,7132137,1093569,8225706,2016
6,20447,U7,U7,USA Jet Airlines Inc.,2,0,0,0,0,0,0,554462,18313,572775,0,0,0,0,0,0,887139,43677,930816,2016
6,19977,UA,UA,United Air Lines Inc.,3,133303370,75608709,55027952,28091245,158727906,292031276,134665784,159357714,294023498,189385490,108426117,79599878,42331562,230357557,419743047,192041302,231311289,423352591,2016
6,21171,VX,VX,Virgin America,3,16745151,0,0,228498,228498,16973649,16849312,228498,17077810,24325534,0,0,401013,401013,24726547,24491852,401013,24892865,2016
6,20308,WE,WE,Centurion Cargo Inc.,2,23981,0,0,23981,23981,47962,23981,474371,498352,46735,0,0,46735,46735,93470,46735,809295,856030,2016
6,20195,WI,WI,Sky Lease Cargo,1,0,0,0,0,0,0,0,0,0,0,0,0,0,0,0,0,0,0,2016
6,20287,WP,WP,Island Air Hawaii,1,166912,0,0,0,0,166912,166912,0,166912,259340,0,0,0,0,259340,259340,0,259340,2016
6,20377,X9,X9,Omni Air Express,2,0,0,0,0,0,0,445543,2159272,2604815,0,0,0,0,0,0,656696,4143888,4800584,2016
6,20207,XP,XP,XTRA Airways,1,0,0,0,0,0,0,230953,508637,739590,0,0,0,0,0,0,478329,1053442,1531771,2016
6,20378,YV,YV,Mesa Airlines Inc.,2,0,0,0,0,0,0,0,0,0,0,0,0,0,0,0,0,0,0,2016
6,20452,YX,YX,Republic Airlines,2,11611850,0,0,0,0,11611850,11611850,0,11611850,15883727,0,0,0,0,15883727,15883727,0,15883727,2016
6,20046,ZW,ZW,Air Wisconsin Airlines Corp,2,6353609,0,0,0,0,6353609,6353609,0,6353609,9333727,0,0,0,0,9333727,9333727,0,9333727,2016
6,19393,WN,WN,Southwest Airlines Co.,3,175188632,0,0,1810634,1810634,176999266,175444931,1810634,177255565,307075537,0,0,3228252,3228252,310303789,307472174,3228252,310700426,2016
7,21161,09Q,09Q,"Swift Air, LLC",1,0,0,0,0,0,0,121373,207228,328601,0,0,0,0,0,0,447055,457544,904599,2016
7,21352,0WQ,0WQ,Avjet Corporation,1,0,0,0,0,0,0,29149,0,29149,0,0,0,0,0,0,85990,0,85990,2016
7,21492,1BQ,1BQ,"Dynamic Airways, LLC",1,0,0,0,0,0,0,0,0,0,0,0,0,0,0,0,0,0,0,2016
7,21645,23Q,23Q,Songbird Airways Inc.,1,0,0,0,0,0,0,17806,100334,118140,0,0,0,0,0,0,35425,199614,235039,2016
7,21652,27Q,27Q,"Jet Aviation Flight Services, Inc.",1,0,0,0,0,0,0,0,0,0,0,0,0,0,0,0,0,0,0,2016
7,20408,5V,5V,Tatonduk Outfitters Limited d/b/a Everts Air Alaska and Everts Air Cargo,1,322527,0,0,0,0,322527,452311,0,452311,667509,0,0,0,0,667509,936113,0,936113,2016
7,19917,5X,5X,United Parcel Service,3,32922000,10460000,16989000,2894000,30343000,63265000,32922000,30343000,63265000,46341000,13190000,23912000,4480000,41582000,87923000,46341000,41582000,87923000,2016
7,20007,5Y,5Y,Atlas Air Inc.,3,0,0,0,0,0,0,6263248,24595969,30859217,0,0,0,0,0,0,14025862,43574035,57599897,2016
7,19874,8C,8C,Air Transport International,2,0,0,0,0,0,0,21765,572953,594718,0,0,0,0,0,0,57777,1069759,1127536,2016
7,20363,9E,9E,Endeavor Air Inc.,2,0,0,0,0,0,0,0,0,0,0,0,0,0,0,0,0,0,0,2016
7,20190,9S,9S,Southern Air Inc.,2,787809,4945037,682722,0,5627759,6415568,787809,5627759,6415568,1654399,10384577,1433717,0,11818294,13472693,1654399,11818294,13472693,2016
7,19805,AA,AA,American Airlines Inc.,3,204635118,61727820,21790542,49534825,133053187,337688305,205233915,133303139,338537054,282005676,85457155,31694150,76953049,194104354,476110030,282820840,194477990,477298830,2016
7,20453,ABX,ABX,ABX Air Inc,2,168462,0,0,0,0,168462,168462,0,168462,353770,0,0,0,0,353770,353770,0,353770,2016
7,19930,AS,AS,Alaska Airlines Inc.,3,41119033,0,0,488517,488517,41607550,41220414,488517,41708931,65222690,0,0,832540,832540,66055230,65365494,832540,66198034,2016
7,20409,B6,B6,JetBlue Airways,3,55413385,0,0,14027783,14027783,69441168,55423261,14096063,69519324,84201340,0,0,21315394,21315394,105516734,84232470,21480409,105712879,2016
7,21167,CP,CP,Compass Airlines,2,0,0,0,0,0,0,0,0,0,0,0,0,0,0,0,0,0,0,2016
7,19790,DL,DL,Delta Air Lines Inc.,3,183235015,81773425,39919490,27641028,149333943,332568958,183965369,149333943,333299312,270477228,120707547,58926035,40801527,220435109,490912337,272794344,220435109,493229453,2016
7,21650,EE,EE,Eastern Airlines Group Inc.,1,0,0,0,0,0,0,141680,470640,612320,0,0,0,0,0,0,240856,800088,1040944,2016
7,20366,EV,EV,ExpressJet Airlines Inc.,3,80896,0,0,0,0,80896,80896,0,80896,230891,0,0,0,0,230891,230891,0,230891,2016
7,20436,F9,F9,Frontier Airlines Inc.,3,19486193,0,0,1036695,1036695,20522888,19491304,1036695,20527999,27089485,0,0,1758561,1758561,28848046,27099940,1758561,28858501,2016
7,20107,FX,FX,Federal Express Corporation,3,57420677,11691792,18323651,1951234,31966677,89387354,58396390,32398223,90794613,79478000,16747000,27085000,2999000,46831000,126309000,80848000,47494000,128342000,2016
7,20368,G4,G4,Allegiant Air,3,17690376,0,0,0,0,17690376,18352864,0,18352864,28712563,0,0,0,0,28712563,29820427,0,29820427,2016
7,20500,G7,G7,GoJet Airlines LLC d/b/a United Express,2,0,0,0,0,0,0,0,0,0,0,0,0,0,0,0,0,0,0,2016
7,20166,GFQ,GFQ,Gulf And Caribbean Cargo,1,0,0,0,0,0,0,178347,102591,280938,0,0,0,0,0,0,353128,206192,559320,2016
7,20402,GL,GL,Miami Air International,2,0,0,0,0,0,0,216723,118541,335264,0,0,0,0,0,0,312235,170783,483018,2016
7,19690,HA,HA,Hawaiian Airlines Inc.,3,16133931,0,6284929,0,6284929,22418860,16133931,6284929,22418860,23088167,0,9140014,0,9140014,32228181,23088167,9140014,32228181,2016
7,20310,WL,K8,"Caribbean Sun Airlines, Inc. d/b/a World Atlantic Airlines",1,0,0,0,0,0,0,86761,102955,189716,0,0,0,0,0,0,206007,244458,450465,2016
7,20370,KAQ,KAQ,Kalitta Air LLC,2,0,0,0,0,0,0,571193,2150245,2721438,0,0,0,0,0,0,900588,3675928,4576516,2016
7,21629,KD,KD,Western Global,1,0,0,0,0,0,0,65171,103732,168903,0,0,0,0,0,0,65171,103732,168903,2016
7,21634,KH,KH,Aloha Air Cargo,1,420630,0,0,0,0,420630,420630,0,420630,602912,0,0,0,0,602912,602912,0,602912,2016
7,20372,KLQ,KLQ,Kalitta Charters II,1,0,0,0,0,0,0,163748,6384,170132,0,0,0,0,0,0,357342,11382,368724,2016
7,20169,L2,L2,Lynden Air Cargo Airlines,1,78773,0,0,0,0,78773,253425,2176,255601,150054,0,0,0,0,150054,502144,3312,505456,2016
7,20151,M6,M6,Amerijet International,2,0,0,0,1512646,1512646,1512646,233120,1659646,1892766,0,0,0,2408633,2408633,2408633,371204,2642706,3013910,2016
7,20398,MQ,MQ,Envoy Air,3,0,0,0,0,0,0,0,0,0,0,0,0,0,0,0,0,0,0,2016
7,20405,N8,N8,National Air Cargo Group Inc d/ba National Airlines,1,79260,0,0,0,0,79260,254891,431390,686281,137435,0,0,0,0,137435,461033,829040,1290073,2016
7,20108,NC,NC,Northern Air Cargo Inc.,1,430263,0,0,0,0,430263,502881,0,502881,698699,0,0,0,0,698699,807428,0,807428,2016
7,20416,NK,NK,Spirit Air Lines,3,24415969,0,0,2094312,2094312,26510281,24415969,2094312,26510281,39089881,0,0,3352987,3352987,42442868,39089881,3352987,42442868,2016
7,20397,OH,OH,PSA Airlines Inc.,2,0,0,0,0,0,0,0,0,0,0,0,0,0,0,0,0,0,0,2016
7,20304,OO,OO,SkyWest Airlines Inc.,3,6489965,0,0,0,0,6489965,6489965,0,6489965,11647680,0,0,0,0,11647680,11647680,0,11647680,2016
7,20177,PFQ,PFQ,Asia Pacific,1,0,0,0,0,0,0,0,318966,318966,0,0,0,0,0,0,0,592222,592222,2016
7,20100,PO,PO,Polar Air Cargo Airways,3,2730335,687815,11025545,0,11713360,14443695,2730335,11713360,14443695,4082396,1213420,16907788,0,18121208,22203604,4082396,18121208,22203604,2016
7,20149,PRQ,PRQ,Florida West Airlines Inc.,1,0,0,0,0,0,0,0,0,0,0,0,0,0,0,0,0,0,0,2016
7,19687,QX,QX,Horizon Air,2,0,0,0,0,0,0,0,0,0,0,0,0,0,0,0,0,0,0,2016
7,20448,S5,S5,Shuttle America Corp.,2,4897404,0,0,0,0,4897404,4897404,0,4897404,6728261,0,0,0,0,6728261,6728261,0,6728261,2016
7,20422,SY,SY,Sun Country Airlines d/b/a MN Airlines,2,3877995,0,0,715296,715296,4593291,4428418,792639,5221057,6009354,0,0,1215510,1215510,7224864,7302490,1340281,8642771,2016
7,20447,U7,U7,USA Jet Airlines Inc.,2,0,0,0,0,0,0,284059,22972,307031,0,0,0,0,0,0,438303,53952,492255,2016
7,19977,UA,UA,United Air Lines Inc.,3,139420157,78304192,58251384,32427759,168983335,308403492,140581589,169366813,309948402,195542705,111630469,86633831,49483955,247748255,443290960,197386646,248320530,445707176,2016
7,21171,VX,VX,Virgin America,3,17537215,0,0,248531,248531,17785746,17646054,248531,17894585,24339406,0,0,413615,413615,24753021,24496885,413615,24910500,2016
7,20308,WE,WE,Centurion Cargo Inc.,2,0,0,0,0,0,0,0,426941,426941,0,0,0,0,0,0,0,693189,693189,2016
7,20195,WI,WI,Sky Lease Cargo,1,0,0,0,0,0,0,0,0,0,0,0,0,0,0,0,0,0,0,2016
7,20287,WP,WP,Island Air Hawaii,1,176438,0,0,0,0,176438,176438,0,176438,269709,0,0,0,0,269709,269709,0,269709,2016
7,20377,X9,X9,Omni Air Express,2,0,0,0,0,0,0,354114,2517992,2872106,0,0,0,0,0,0,622892,4771106,5393998,2016
7,20207,XP,XP,XTRA Airways,1,0,0,0,0,0,0,260360,520597,780957,0,0,0,0,0,0,447748,1176199,1623947,2016
7,20378,YV,YV,Mesa Airlines Inc.,2,0,0,0,0,0,0,0,0,0,0,0,0,0,0,0,0,0,0,2016
7,20452,YX,YX,Republic Airlines,2,11951675,0,0,0,0,11951675,11951675,0,11951675,16611835,0,0,0,0,16611835,16611835,0,16611835,2016
7,20046,ZW,ZW,Air Wisconsin Airlines Corp,2,6345731,0,0,0,0,6345731,6345731,0,6345731,10035625,0,0,0,0,10035625,10035625,0,10035625,2016
7,19393,WN,WN,Southwest Airlines Co.,3,179337963,0,0,1937094,1937094,181275057,179599764,1937094,181536858,315134560,0,0,3650102,3650102,318784662,315537960,3650102,319188062,2016
8,21161,09Q,09Q,"Swift Air, LLC",1,0,0,0,0,0,0,40719,187848,228567,0,0,0,0,0,0,167240,295643,462883,2016
8,21352,0WQ,0WQ,Avjet Corporation,1,0,0,0,0,0,0,34677,0,34677,0,0,0,0,0,0,104722,0,104722,2016
8,21492,1BQ,1BQ,"Dynamic Airways, LLC",1,0,0,0,0,0,0,0,0,0,0,0,0,0,0,0,0,0,0,2016
8,21645,23Q,23Q,Songbird Airways Inc.,1,0,0,0,0,0,0,0,122224,122224,0,0,0,0,0,0,0,271906,271906,2016
8,21652,27Q,27Q,"Jet Aviation Flight Services, Inc.",1,0,0,0,0,0,0,0,0,0,0,0,0,0,0,0,0,0,0,2016
8,20408,5V,5V,Tatonduk Outfitters Limited d/b/a Everts Air Alaska and Everts Air Cargo,1,331568,0,0,0,0,331568,441778,0,441778,733365,0,0,0,0,733365,977129,0,977129,2016
8,19917,5X,5X,United Parcel Service,3,35770000,10486000,17396000,3113000,30995000,66765000,35770000,30995000,66765000,47121000,12212000,22847000,4567000,39626000,86747000,47121000,39626000,86747000,2016
8,20007,5Y,5Y,Atlas Air Inc.,3,0,0,0,0,0,0,6644573,25025220,31669793,0,0,0,0,0,0,11184426,43624699,54809125,2016
8,19874,8C,8C,Air Transport International,2,0,0,0,0,0,0,15126,645953,661079,0,0,0,0,0,0,38689,1254146,1292835,2016
8,20363,9E,9E,Endeavor Air Inc.,2,0,0,0,0,0,0,0,0,0,0,0,0,0,0,0,0,0,0,2016
8,20190,9S,9S,Southern Air Inc.,2,752856,4622072,556123,0,5178195,5931051,752856,5178195,5931051,1580999,9706352,1167859,0,10874211,12455210,1580999,10874211,12455210,2016
8,19805,AA,AA,American Airlines Inc.,3,196114211,61115780,21704310,46448725,129268815,325383026,196986308,129340833,326327141,249130633,82064085,36814802,68343166,187222053,436352686,250264515,187329768,437594283,2016
8,20453,ABX,ABX,ABX Air Inc,2,112827,0,0,0,0,112827,112827,0,112827,353770,0,0,0,0,353770,353770,0,353770,2016
8,19930,AS,AS,Alaska Airlines Inc.,3,41552682,0,0,413046,413046,41965728,41625536,413046,42038582,61609734,0,0,669734,669734,62279468,61706970,669734,62376704,2016
8,20409,B6,B6,JetBlue Airways,3,55139033,0,0,14224067,14224067,69363100,55139033,14306537,69445570,78164116,0,0,20163784,20163784,98327900,78164116,20318053,98482169,2016
8,21167,CP,CP,Compass Airlines,2,0,0,0,0,0,0,0,0,0,0,0,0,0,0,0,0,0,0,2016
8,19790,DL,DL,Delta Air Lines Inc.,3,178322803,79329434,40359775,26144500,145833709,324156512,179284649,145901970,325186619,274509560,122119480,62129711,40246761,224495952,499005512,277034266,224601033,501635299,2016
8,21650,EE,EE,Eastern Airlines Group Inc.,1,0,0,0,0,0,0,107520,446480,554000,0,0,0,0,0,0,181709,754551,936260,2016
8,20366,EV,EV,ExpressJet Airlines Inc.,3,82119,0,0,0,0,82119,82119,0,82119,210836,0,0,0,0,210836,210836,0,210836,2016
8,20436,F9,F9,Frontier Airlines Inc.,3,19333076,0,0,667550,667550,20000626,19334029,667550,20001579,24523237,0,0,797486,797486,25320723,24524756,797486,25322242,2016
8,20107,FX,FX,Federal Express Corporation,3,58892020,11694697,19234563,2081069,33010329,91902349,59971704,33396648,93368352,76959000,15826000,26775000,3248000,45849000,122808000,78393000,46387000,124780000,2016
8,20368,G4,G4,Allegiant Air,3,13526551,0,0,0,0,13526551,14225856,0,14225856,20497989,0,0,0,0,20497989,21647166,0,21647166,2016
8,20500,G7,G7,GoJet Airlines LLC d/b/a United Express,2,0,0,0,0,0,0,0,0,0,0,0,0,0,0,0,0,0,0,2016
8,20166,GFQ,GFQ,Gulf And Caribbean Cargo,1,0,0,0,0,0,0,243299,176176,419475,0,0,0,0,0,0,472592,356377,828969,2016
8,20402,GL,GL,Miami Air International,2,0,0,0,0,0,0,190259,150488,340747,0,0,0,0,0,0,431934,341644,773578,2016
8,19690,HA,HA,Hawaiian Airlines Inc.,3,15631621,0,6699830,0,6699830,22331451,15661235,6699830,22361065,20911560,0,9069750,0,9069750,29981310,20951120,9069750,30020870,2016
8,20310,WL,K8,"Caribbean Sun Airlines, Inc. d/b/a World Atlantic Airlines",1,0,0,0,0,0,0,96507,47388,143895,0,0,0,0,0,0,203618,99983,303601,2016
8,20370,KAQ,KAQ,Kalitta Air LLC,2,0,0,0,0,0,0,864632,2765687,3630319,0,0,0,0,0,0,1327435,4579633,5907068,2016
8,21629,KD,KD,Western Global,1,0,0,0,0,0,0,34354,0,34354,0,0,0,0,0,0,34354,0,34354,2016
8,21634,KH,KH,Aloha Air Cargo,1,453731,0,0,0,0,453731,453731,0,453731,606746,0,0,0,0,606746,606746,0,606746,2016
8,20372,KLQ,KLQ,Kalitta Charters II,1,0,0,0,0,0,0,167756,71343,239099,0,0,0,0,0,0,332405,141257,473662,2016
8,20169,L2,L2,Lynden Air Cargo Airlines,1,84816,0,0,0,0,84816,251512,0,251512,146763,0,0,0,0,146763,478167,0,478167,2016
8,20151,M6,M6,Amerijet International,2,0,0,0,1585780,1585780,1585780,235657,1640481,1876138,0,0,0,2416460,2416460,2416460,359101,2499815,2858916,2016
8,20398,MQ,MQ,Envoy Air,3,0,0,0,0,0,0,0,0,0,0,0,0,0,0,0,0,0,0,2016
8,20405,N8,N8,National Air Cargo Group Inc d/ba National Airlines,1,60623,0,0,0,0,60623,106998,605314,712312,98219,0,0,0,0,98219,186025,1036379,1222404,2016
8,20108,NC,NC,Northern Air Cargo Inc.,1,471333,0,0,0,0,471333,584706,11350,596056,719352,0,0,0,0,719352,905120,23575,928695,2016
8,20416,NK,NK,Spirit Air Lines,3,24633261,0,0,2525792,2525792,27159053,24633261,2525792,27159053,37157939,0,0,3810020,3810020,40967959,37157939,3810020,40967959,2016
8,20397,OH,OH,PSA Airlines Inc.,2,0,0,0,0,0,0,0,0,0,0,0,0,0,0,0,0,0,0,2016
8,20304,OO,OO,SkyWest Airlines Inc.,3,6548860,0,0,0,0,6548860,6548860,0,6548860,11535275,0,0,0,0,11535275,11535275,0,11535275,2016
8,20177,PFQ,PFQ,Asia Pacific,1,0,0,0,0,0,0,0,333553,333553,0,0,0,0,0,0,0,576221,576221,2016
8,20100,PO,PO,Polar Air Cargo Airways,3,2684927,669467,11613707,0,12283174,14968101,2684927,12283174,14968101,3723683,1137776,16530385,0,17668161,21391844,3723683,17668161,21391844,2016
8,20149,PRQ,PRQ,Florida West Airlines Inc.,1,0,0,0,0,0,0,0,0,0,0,0,0,0,0,0,0,0,0,2016
8,19687,QX,QX,Horizon Air,2,0,0,0,0,0,0,0,0,0,0,0,0,0,0,0,0,0,0,2016
8,20448,S5,S5,Shuttle America Corp.,2,4935993,0,0,0,0,4935993,4935993,0,4935993,6564449,0,0,0,0,6564449,6564449,0,6564449,2016
8,20422,SY,SY,Sun Country Airlines d/b/a MN Airlines,2,3638729,0,0,412582,412582,4051311,4164669,475075,4639744,5313794,0,0,649749,649749,5963543,6518042,755676,7273718,2016
8,20447,U7,U7,USA Jet Airlines Inc.,2,0,0,0,0,0,0,556244,17242,573486,0,0,0,0,0,0,826579,36747,863326,2016
8,19977,UA,UA,United Air Lines Inc.,3,141031181,76818368,58039462,26851685,161709515,302740696,142245099,162311297,304556396,186832004,103501342,81354762,38242117,223098221,409930225,189370637,223990050,413360687,2016
8,21171,VX,VX,Virgin America,3,17587802,0,0,212432,212432,17800234,17647370,212432,17859802,22660606,0,0,334925,334925,22995531,22740515,334925,23075440,2016
8,20308,WE,WE,Centurion Cargo Inc.,2,0,0,0,0,0,0,0,585272,585272,0,0,0,0,0,0,0,868206,868206,2016
8,20195,WI,WI,Sky Lease Cargo,1,0,0,0,0,0,0,0,0,0,0,0,0,0,0,0,0,0,0,2016
8,20287,WP,WP,Island Air Hawaii,1,174085,0,0,0,0,174085,174085,0,174085,237468,0,0,0,0,237468,237468,0,237468,2016
8,20377,X9,X9,Omni Air Express,2,0,0,0,0,0,0,383080,2547887,2930967,0,0,0,0,0,0,575440,4920515,5495955,2016
8,20207,XP,XP,XTRA Airways,1,0,0,0,0,0,0,215308,191710,407018,0,0,0,0,0,0,428354,383329,811683,2016
8,20378,YV,YV,Mesa Airlines Inc.,2,0,0,0,0,0,0,0,0,0,0,0,0,0,0,0,0,0,0,2016
8,20452,YX,YX,Republic Airlines,2,12008810,0,0,0,0,12008810,12008810,0,12008810,15891945,0,0,0,0,15891945,15891945,0,15891945,2016
8,20046,ZW,ZW,Air Wisconsin Airlines Corp,2,6353980,0,0,0,0,6353980,6353980,0,6353980,9669585,0,0,0,0,9669585,9669585,0,9669585,2016
8,19393,WN,WN,Southwest Airlines Co.,3,170501581,0,0,1257322,1257322,171758903,170664691,1257322,171922013,293335028,0,0,2234234,2234234,295569262,293558949,2234234,295793183,2016
9,21161,09Q,09Q,"Swift Air, LLC",1,0,0,0,0,0,0,105030,190092,295122,0,0,0,0,0,0,324825,322313,647138,2016
9,21352,0WQ,0WQ,Avjet Corporation,1,0,0,0,0,0,0,26941,1538,28479,0,0,0,0,0,0,78401,4474,82875,2016
9,21492,1BQ,1BQ,"Dynamic Airways, LLC",1,0,0,0,0,0,0,0,0,0,0,0,0,0,0,0,0,0,0,2016
9,21645,23Q,23Q,Songbird Airways Inc.,1,0,0,0,0,0,0,6228,118036,124264,0,0,0,0,0,0,12432,277090,289522,2016
9,21652,27Q,27Q,"Jet Aviation Flight Services, Inc.",1,0,0,0,0,0,0,0,0,0,0,0,0,0,0,0,0,0,0,2016
9,20408,5V,5V,Tatonduk Outfitters Limited d/b/a Everts Air Alaska and Everts Air Cargo,1,308469,0,0,0,0,308469,387562,0,387562,703500,0,0,0,0,703500,883881,0,883881,2016
9,19917,5X,5X,United Parcel Service,3,34776000,10310000,17183000,2941000,30434000,65210000,34776000,30434000,65210000,48786000,12511000,22938000,4514000,39963000,88749000,48786000,39963000,88749000,2016
9,20007,5Y,5Y,Atlas Air Inc.,3,0,0,0,0,0,0,7734601,25907171,33641772,0,0,0,0,0,0,12983973,44310804,57294777,2016
9,19874,8C,8C,Air Transport International,2,0,0,0,0,0,0,35502,596887,632389,0,0,0,0,0,0,68697,1134430,1203127,2016
9,20363,9E,9E,Endeavor Air Inc.,2,0,0,0,0,0,0,0,0,0,0,0,0,0,0,0,0,0,0,2016
9,20190,9S,9S,Southern Air Inc.,2,887509,4919457,643686,0,5563143,6450652,887509,5563143,6450652,1863769,10330859,1351741,0,11682600,13546369,1863769,11682600,13546369,2016
9,19805,AA,AA,American Airlines Inc.,3,170338805,57537180,22197999,37108832,116844011,287182816,171084164,116975465,288059629,234900974,76084402,31595655,55660902,163340959,398241933,235910254,163537463,399447717,2016
9,20453,ABX,ABX,ABX Air Inc,2,186590,0,0,0,0,186590,186590,0,186590,353377,0,0,0,0,353377,353377,0,353377,2016
9,19930,AS,AS,Alaska Airlines Inc.,3,35298306,0,0,297338,297338,35595644,35383965,297338,35681303,54749763,0,0,515386,515386,55265149,54866874,515386,55382260,2016
9,20409,B6,B6,JetBlue Airways,3,48912738,0,0,10239151,10239151,59151889,48995178,10293181,59288359,73338622,0,0,15352345,15352345,88690967,73436304,15464214,88900518,2016
9,21167,CP,CP,Compass Airlines,2,0,0,0,0,0,0,0,0,0,0,0,0,0,0,0,0,0,0,2016
9,19790,DL,DL,Delta Air Lines Inc.,3,154742380,69860942,38563303,19328700,127752945,282495325,155849906,127784389,283634295,219939706,99295326,54811110,27472427,181578863,401518569,222680764,181623555,404304319,2016
9,21650,EE,EE,Eastern Airlines Group Inc.,1,0,0,0,0,0,0,152640,243040,395680,0,0,0,0,0,0,274752,437472,712224,2016
9,20366,EV,EV,ExpressJet Airlines Inc.,3,90640,0,0,0,0,90640,90640,0,90640,242775,0,0,0,0,242775,242775,0,242775,2016
9,20436,F9,F9,Frontier Airlines Inc.,3,18739285,0,0,457011,457011,19196296,18739285,457011,19196296,25443200,0,0,676721,676721,26119921,25443200,676721,26119921,2016
9,20107,FX,FX,Federal Express Corporation,3,56823678,11799153,18428736,1993449,32221338,89045016,57993164,32592151,90585315,77738000,16649000,25755000,3172000,45576000,123314000,79394000,46115000,125509000,2016
9,20368,G4,G4,Allegiant Air,3,10834580,0,0,0,0,10834580,11608073,0,11608073,17493610,0,0,0,0,17493610,18949260,0,18949260,2016
9,20500,G7,G7,GoJet Airlines LLC d/b/a United Express,2,0,0,0,0,0,0,0,0,0,0,0,0,0,0,0,0,0,0,2016
9,20166,GFQ,GFQ,Gulf And Caribbean Cargo,1,0,0,0,0,0,0,216058,146428,362486,0,0,0,0,0,0,403180,296142,699322,2016
9,20402,GL,GL,Miami Air International,2,0,0,0,0,0,0,357302,97523,454825,0,0,0,0,0,0,801156,218670,1019826,2016
9,19690,HA,HA,Hawaiian Airlines Inc.,3,13574081,0,6502941,0,6502941,20077022,13634666,6502941,20137607,18984453,0,9065212,0,9065212,28049665,19067372,9065212,28132584,2016
9,20310,WL,K8,"Caribbean Sun Airlines, Inc. d/b/a World Atlantic Airlines",1,0,0,0,0,0,0,105030,8314,113344,0,0,0,0,0,0,219872,17405,237277,2016
9,20370,KAQ,KAQ,Kalitta Air LLC,2,0,0,0,0,0,0,1042951,2598326,3641277,0,0,0,0,0,0,1592062,4320210,5912272,2016
9,21629,KD,KD,Western Global,1,0,0,0,0,0,0,15676,112191,127867,0,0,0,0,0,0,15676,112191,127867,2016
9,21634,KH,KH,Aloha Air Cargo,1,434148,0,0,0,0,434148,434148,0,434148,612176,0,0,0,0,612176,612176,0,612176,2016
9,20372,KLQ,KLQ,Kalitta Charters II,1,0,0,0,0,0,0,260210,67061,327271,0,0,0,0,0,0,559616,126915,686531,2016
9,20169,L2,L2,Lynden Air Cargo Airlines,1,79820,0,0,0,0,79820,160098,1823,161921,143072,0,0,0,0,143072,322206,3901,326107,2016
9,20151,M6,M6,Amerijet International,2,0,0,0,1464620,1464620,1464620,219149,1498978,1718127,0,0,0,2336309,2336309,2336309,349579,2391116,2740695,2016
9,20398,MQ,MQ,Envoy Air,3,0,0,0,0,0,0,0,0,0,0,0,0,0,0,0,0,0,0,2016
9,20405,N8,N8,National Air Cargo Group Inc d/ba National Airlines,1,52016,0,0,0,0,52016,131476,929146,1060622,94941,0,0,0,0,94941,269436,1719112,1988548,2016
9,20108,NC,NC,Northern Air Cargo Inc.,1,399906,0,0,0,0,399906,463900,27223,491123,637705,0,0,0,0,637705,751572,53113,804685,2016
9,20416,NK,NK,Spirit Air Lines,3,22722981,0,0,1895633,1895633,24618614,22722981,1895633,24618614,35473689,0,0,2959344,2959344,38433033,35473689,2959344,38433033,2016
9,20397,OH,OH,PSA Airlines Inc.,2,0,0,0,0,0,0,0,0,0,0,0,0,0,0,0,0,0,0,2016
9,20304,OO,OO,SkyWest Airlines Inc.,3,5643514,0,0,0,0,5643514,5643514,0,5643514,8966030,0,0,0,0,8966030,8966030,0,8966030,2016
9,20177,PFQ,PFQ,Asia Pacific,1,0,0,0,0,0,0,0,337327,337327,0,0,0,0,0,0,0,622885,622885,2016
9,20100,PO,PO,Polar Air Cargo Airways,3,2569876,657477,10882382,0,11539859,14109735,2569876,11539859,14109735,3773102,1136385,15102744,0,16239129,20012231,3773102,16239129,20012231,2016
9,20149,PRQ,PRQ,Florida West Airlines Inc.,1,0,0,0,0,0,0,0,0,0,0,0,0,0,0,0,0,0,0,2016
9,19687,QX,QX,Horizon Air,2,0,0,0,0,0,0,0,0,0,0,0,0,0,0,0,0,0,0,2016
9,20448,S5,S5,Shuttle America Corp.,2,4093952,0,0,0,0,4093952,4093952,0,4093952,5666797,0,0,0,0,5666797,5666797,0,5666797,2016
9,20422,SY,SY,Sun Country Airlines d/b/a MN Airlines,2,2795007,0,0,111417,111417,2906424,3460835,158103,3618938,4310584,0,0,188796,188796,4499380,5706868,271669,5978537,2016
9,20447,U7,U7,USA Jet Airlines Inc.,2,0,0,0,0,0,0,667468,12339,679807,0,0,0,0,0,0,1031906,27405,1059311,2016
9,19977,UA,UA,United Air Lines Inc.,3,128040494,70113254,55384149,19234413,144731816,272772310,129425994,145247990,274673984,176340779,97423930,78012640,28445672,203882242,380223021,178628479,204627367,383255846,2016
9,21171,VX,VX,Virgin America,3,15942332,0,0,123436,123436,16065768,16014741,123436,16138177,21831896,0,0,208836,208836,22040732,21936560,208836,22145396,2016
9,20308,WE,WE,Centurion Cargo Inc.,2,0,0,0,0,0,0,0,525640,525640,0,0,0,0,0,0,0,849657,849657,2016
9,20195,WI,WI,Sky Lease Cargo,1,0,0,0,0,0,0,0,0,0,0,0,0,0,0,0,0,0,0,2016
9,20287,WP,WP,Island Air Hawaii,1,161426,0,0,0,0,161426,161426,0,161426,225221,0,0,0,0,225221,225221,0,225221,2016
9,20377,X9,X9,Omni Air Express,2,0,0,0,0,0,0,350893,1816061,2166954,0,0,0,0,0,0,600733,3355654,3956387,2016
9,20207,XP,XP,XTRA Airways,1,0,0,0,0,0,0,352458,53300,405758,0,0,0,0,0,0,701213,118743,819956,2016
9,20378,YV,YV,Mesa Airlines Inc.,2,0,0,0,0,0,0,0,0,0,0,0,0,0,0,0,0,0,0,2016
9,20452,YX,YX,Republic Airlines,2,10210565,0,0,0,0,10210565,10210565,0,10210565,13956065,0,0,0,0,13956065,13956065,0,13956065,2016
9,20046,ZW,ZW,Air Wisconsin Airlines Corp,2,10633,0,0,0,0,10633,10633,0,10633,31571,0,0,0,0,31571,31571,0,31571,2016
9,19393,WN,WN,Southwest Airlines Co.,3,158617532,0,0,872083,872083,159489615,158891824,872083,159763907,281334875,0,0,1603272,1603272,282938147,281758512,1603272,283361784,2016
10,21161,09Q,09Q,"Swift Air, LLC",1,0,0,0,0,0,0,200338,121621,321959,0,0,0,0,0,0,610145,276078,886223,2016
10,21352,0WQ,0WQ,Avjet Corporation,1,0,0,0,0,0,0,18771,0,18771,0,0,0,0,0,0,56503,0,56503,2016
10,21492,1BQ,1BQ,"Dynamic Airways, LLC",1,0,0,0,0,0,0,74629,620566,695195,0,0,0,0,0,0,113313,945687,1059000,2016
10,21645,23Q,23Q,Songbird Airways Inc.,1,0,0,0,0,0,0,4955,95987,100942,0,0,0,0,0,0,9858,190966,200824,2016
10,21652,27Q,27Q,"Jet Aviation Flight Services, Inc.",1,0,0,0,0,0,0,0,0,0,0,0,0,0,0,0,0,0,0,2016
10,20408,5V,5V,Tatonduk Outfitters Limited d/b/a Everts Air Alaska and Everts Air Cargo,1,305387,0,0,0,0,305387,428555,0,428555,712499,0,0,0,0,712499,999862,0,999862,2016
10,19917,5X,5X,United Parcel Service,3,33745000,10803000,17653000,2986000,31442000,65187000,33745000,31442000,65187000,50360000,13956000,24298000,4851000,43105000,93465000,50360000,43105000,93465000,2016
10,20007,5Y,5Y,Atlas Air Inc.,3,0,0,0,0,0,0,7806925,29214089,37021014,0,0,0,0,0,0,13824941,49825467,63650408,2016
10,19874,8C,8C,Air Transport International,2,0,0,0,0,0,0,19955,611549,631504,0,0,0,0,0,0,44931,1161812,1206743,2016
10,20363,9E,9E,Endeavor Air Inc.,2,0,0,0,0,0,0,0,0,0,0,0,0,0,0,0,0,0,0,2016
10,20190,9S,9S,Southern Air Inc.,2,862497,4732533,601245,0,5333778,6196275,862497,5333778,6196275,1811245,9938318,1262614,0,11200932,13012177,1811245,11200932,13012177,2016
10,19805,AA,AA,American Airlines Inc.,3,174991922,54105851,23218015,39893922,117217788,292209710,175725146,117303557,293028703,249379669,76327982,33233429,62724370,172285781,421665450,250419257,172431149,422850406,2016
10,20453,ABX,ABX,ABX Air Inc,2,100804,0,0,0,0,100804,100804,0,100804,166327,0,0,0,0,166327,166327,0,166327,2016
10,19930,AS,AS,Alaska Airlines Inc.,3,35736983,0,0,611710,611710,36348693,35852429,611710,36464139,59128111,0,0,1075828,1075828,60203939,59295203,1075828,60371031,2016
10,20409,B6,B6,JetBlue Airways,3,49680631,0,0,10315956,10315956,59996587,49796296,10360416,60156712,76360520,0,0,15855914,15855914,92216434,76518010,15942900,92460910,2016
10,21167,CP,CP,Compass Airlines,2,0,0,0,0,0,0,0,0,0,0,0,0,0,0,0,0,0,0,2016
10,19790,DL,DL,Delta Air Lines Inc.,3,160469980,62419234,34937646,18324900,115681780,276151760,162455296,116201586,278656882,273932025,106553432,59640688,31281719,197475839,471407864,278373702,198363180,476736882,2016
10,21650,EE,EE,Eastern Airlines Group Inc.,1,0,0,0,0,0,0,244400,248800,493200,0,0,0,0,0,0,405704,413008,818712,2016
10,20366,EV,EV,ExpressJet Airlines Inc.,3,83641,0,0,0,0,83641,83641,0,83641,234987,0,0,0,0,234987,234987,0,234987,2016
10,20436,F9,F9,Frontier Airlines Inc.,3,18493969,0,0,778087,778087,19272056,18494105,778087,19272192,26551046,0,0,1156114,1156114,27707160,26551284,1156114,27707398,2016
10,20107,FX,FX,Federal Express Corporation,3,57034250,11916224,19217268,1979596,33113088,90147338,58138543,33783234,91921777,83862000,17926000,27856000,3257000,49039000,132901000,85517000,50089000,135606000,2016
10,20368,G4,G4,Allegiant Air,3,12808253,0,0,0,0,12808253,13580127,0,13580127,21940025,0,0,0,0,21940025,23346221,0,23346221,2016
10,20500,G7,G7,GoJet Airlines LLC d/b/a United Express,2,0,0,0,0,0,0,0,0,0,0,0,0,0,0,0,0,0,0,2016
10,20166,GFQ,GFQ,Gulf And Caribbean Cargo,1,0,0,0,0,0,0,320447,209119,529566,0,0,0,0,0,0,619692,420709,1040401,2016
10,20402,GL,GL,Miami Air International,2,0,0,0,0,0,0,409630,159227,568857,0,0,0,0,0,0,995389,386915,1382304,2016
10,19690,HA,HA,Hawaiian Airlines Inc.,3,13755596,0,6584078,0,6584078,20339674,13858423,6584078,20442501,20371964,0,9558562,0,9558562,29930526,20535622,9558562,30094184,2016
10,20310,WL,K8,"Caribbean Sun Airlines, Inc. d/b/a World Atlantic Airlines",1,0,0,0,0,0,0,143388,3850,147238,0,0,0,0,0,0,387588,10407,397995,2016
10,20370,KAQ,KAQ,Kalitta Air LLC,2,0,0,0,0,0,0,1102916,3122619,4225535,0,0,0,0,0,0,1873721,5679393,7553114,2016
10,21629,KD,KD,Western Global,1,0,0,0,0,0,0,412813,1461322,1874135,0,0,0,0,0,0,412813,1461322,1874135,2016
10,21634,KH,KH,Aloha Air Cargo,1,442368,0,0,0,0,442368,442368,0,442368,668825,0,0,0,0,668825,668825,0,668825,2016
10,20372,KLQ,KLQ,Kalitta Charters II,1,0,0,0,0,0,0,281668,78030,359698,0,0,0,0,0,0,609318,174900,784218,2016
10,20169,L2,L2,Lynden Air Cargo Airlines,1,86514,0,0,0,0,86514,158460,2036,160496,154752,0,0,0,0,154752,323804,4357,328161,2016
10,20151,M6,M6,Amerijet International,2,0,0,0,1462109,1462109,1462109,254313,1551766,1806079,0,0,0,2457685,2457685,2457685,427479,2608391,3035870,2016
10,20398,MQ,MQ,Envoy Air,3,0,0,0,0,0,0,0,0,0,0,0,0,0,0,0,0,0,0,2016
10,20405,N8,N8,National Air Cargo Group Inc d/ba National Airlines,1,42978,0,0,0,0,42978,51289,1542178,1593467,100571,0,0,0,0,100571,120669,3188568,3309237,2016
10,20108,NC,NC,Northern Air Cargo Inc.,1,368895,0,0,0,0,368895,524538,54401,578939,645688,0,0,0,0,645688,935413,111437,1046850,2016
10,20416,NK,NK,Spirit Air Lines,3,22987667,0,0,1730254,1730254,24717921,22987667,1730254,24717921,38191955,0,0,2874663,2874663,41066618,38191955,2874663,41066618,2016
10,20397,OH,OH,PSA Airlines Inc.,2,0,0,0,0,0,0,0,0,0,0,0,0,0,0,0,0,0,0,2016
10,20304,OO,OO,SkyWest Airlines Inc.,3,5715200,0,0,0,0,5715200,5715200,0,5715200,10322219,0,0,0,0,10322219,10322219,0,10322219,2016
10,20177,PFQ,PFQ,Asia Pacific,1,0,0,0,0,0,0,0,337627,337627,0,0,0,0,0,0,0,610043,610043,2016
10,20100,PO,PO,Polar Air Cargo Airways,3,2888776,711234,11725941,0,12437175,15325951,2888776,12437175,15325951,4476303,1321181,16262205,0,17583386,22059689,4476303,17583386,22059689,2016
10,20149,PRQ,PRQ,Florida West Airlines Inc.,1,0,0,0,0,0,0,0,0,0,0,0,0,0,0,0,0,0,0,2016
10,19687,QX,QX,Horizon Air,2,0,0,0,0,0,0,0,0,0,0,0,0,0,0,0,0,0,0,2016
10,20448,S5,S5,Shuttle America Corp.,2,3757754,0,0,0,0,3757754,3757754,0,3757754,5528358,0,0,0,0,5528358,5528358,0,5528358,2016
10,20422,SY,SY,Sun Country Airlines d/b/a MN Airlines,2,3122094,0,0,244631,244631,3366725,4007624,339778,4347402,5094190,0,0,426587,426587,5520777,7024351,599304,7623655,2016
10,20447,U7,U7,USA Jet Airlines Inc.,2,0,0,0,0,0,0,624622,17320,641942,0,0,0,0,0,0,1011994,40768,1052762,2016
10,19977,UA,UA,United Air Lines Inc.,3,132234279,66488923,57018490,20978897,144486310,276720589,133758006,145149976,278907982,193065008,96695719,84147328,32197580,213040627,406105635,195620601,214063491,409684092,2016
10,21171,VX,VX,Virgin America,3,16005733,0,0,151433,151433,16157166,16135480,151433,16286913,23658919,0,0,251775,251775,23910694,23861410,251775,24113185,2016
10,20308,WE,WE,Centurion Cargo Inc.,2,0,0,0,0,0,0,0,457498,457498,0,0,0,0,0,0,0,760982,760982,2016
10,20195,WI,WI,Sky Lease Cargo,1,0,0,0,0,0,0,0,0,0,0,0,0,0,0,0,0,0,0,2016
10,20287,WP,WP,Island Air Hawaii,1,162251,0,0,0,0,162251,162251,0,162251,241206,0,0,0,0,241206,241206,0,241206,2016
10,20377,X9,X9,Omni Air International LLC,2,0,0,0,0,0,0,428789,2845883,3274672,0,0,0,0,0,0,758421,5633709,6392130,2016
10,20207,XP,XP,XTRA Airways,1,0,0,0,0,0,0,373874,125489,499363,0,0,0,0,0,0,743821,249660,993481,2016
10,20378,YV,YV,Mesa Airlines Inc.,2,0,0,0,0,0,0,0,0,0,0,0,0,0,0,0,0,0,0,2016
10,20452,YX,YX,Republic Airlines,2,10410132,0,0,0,0,10410132,10410132,0,10410132,14775468,0,0,0,0,14775468,14775468,0,14775468,2016
10,20046,ZW,ZW,Air Wisconsin Airlines Corp,2,14322,0,0,0,0,14322,14322,0,14322,42800,0,0,0,0,42800,42800,0,42800,2016
10,19393,WN,WN,Southwest Airlines Co.,3,163399948,0,0,948297,948297,164348245,163531112,948297,164479409,298036786,0,0,1802057,1802057,299838843,298242056,1802057,300044113,2016
11,21161,09Q,09Q,"Swift Air, LLC",1,0,0,0,0,0,0,211028,173903,384931,0,0,0,0,0,0,697099,217700,914799,2016
11,21352,0WQ,0WQ,Avjet Corporation,1,0,0,0,0,0,0,19893,0,19893,0,0,0,0,0,0,57489,0,57489,2016
11,21492,1BQ,1BQ,"Dynamic Airways, LLC",1,0,0,0,0,0,0,93385,479426,572811,0,0,0,0,0,0,181829,933684,1115513,2016
11,21645,23Q,23Q,Songbird Airways Inc.,1,0,0,0,0,0,0,20796,156680,177476,0,0,0,0,0,0,61368,323679,385047,2016
11,21652,27Q,27Q,"Jet Aviation Flight Services, Inc.",1,0,0,0,0,0,0,0,0,0,0,0,0,0,0,0,0,0,0,2016
11,20408,5V,5V,Tatonduk Outfitters Limited d/b/a Everts Air Alaska and Everts Air Cargo,1,282065,0,0,0,0,282065,353638,0,353638,649114,0,0,0,0,649114,813824,0,813824,2016
11,19917,5X,5X,United Parcel Service,3,38587000,11262000,19474000,3067000,33803000,72390000,38587000,33803000,72390000,55765000,14514000,28225000,4832000,47571000,103336000,55765000,47571000,103336000,2016
11,20007,5Y,5Y,Atlas Air Inc.,3,0,0,0,0,0,0,7301656,26699641,34001297,0,0,0,0,0,0,12252236,42622986,54875222,2016
11,19874,8C,8C,Air Transport International,2,0,0,0,0,0,0,13395,593597,606992,0,0,0,0,0,0,46526,1105083,1151609,2016
11,20363,9E,9E,Endeavor Air Inc.,2,0,0,0,0,0,0,0,0,0,0,0,0,0,0,0,0,0,0,2016
11,20190,9S,9S,Southern Air Inc.,2,867521,4803787,608528,0,5412315,6279836,867521,5412315,6279836,1821794,10087954,1277909,0,11365863,13187657,1821794,11365863,13187657,2016
11,19805,AA,AA,American Airlines Inc.,3,169178655,35257983,21514895,42327959,99100837,268279492,169808874,99168268,268977142,240792700,51079124,32112765,66693499,149885388,390678088,241684432,149993677,391678109,2016
11,20453,ABX,ABX,ABX Air Inc,2,45896,0,0,0,0,45896,45896,0,45896,82145,0,0,0,0,82145,82145,0,82145,2016
11,19930,AS,AS,Alaska Airlines Inc.,3,36721009,0,0,720965,720965,37441974,36846470,720965,37567435,59592117,0,0,1228528,1228528,60820645,59773980,1228528,61002508,2016
11,20409,B6,B6,JetBlue Airways,3,49576526,0,0,10539120,10539120,60115646,49642856,10577220,60220076,76396903,0,0,16240673,16240673,92637576,76487945,16309212,92797157,2016
11,21167,CP,CP,Compass Airlines,2,0,0,0,0,0,0,0,0,0,0,0,0,0,0,0,0,0,0,2016
11,19790,DL,DL,Delta Air Lines Inc.,3,152355763,45248959,28666634,18193646,92109239,244465002,154388523,92209651,246598174,237908722,70657793,44763926,28409998,143831717,381740439,241916874,143988514,385905388,2016
11,21650,EE,EE,Eastern Airlines Group Inc.,1,0,0,0,0,0,0,217760,283360,501120,0,0,0,0,0,0,466006,606390,1072396,2016
11,20366,EV,EV,ExpressJet Airlines Inc.,3,85810,0,0,0,0,85810,85810,0,85810,218525,0,0,0,0,218525,218525,0,218525,2016
11,20436,F9,F9,Frontier Airlines Inc.,3,17166634,0,0,1423793,1423793,18590427,17166634,1423793,18590427,23927502,0,0,2139885,2139885,26067387,23927502,2139885,26067387,2016
11,20107,FX,FX,Federal Express Corporation,3,59577156,11855128,19761060,1997608,33613796,93190952,60821630,33870991,94692621,84448,17443,30146,3258,50847,135295,86234,51229,137463,2016
11,20368,G4,G4,Allegiant Air,3,12837536,0,0,0,0,12837536,13489524,0,13489524,21019968,0,0,0,0,21019968,22205282,0,22205282,2016
11,20500,G7,G7,GoJet Airlines LLC d/b/a United Express,2,0,0,0,0,0,0,0,0,0,0,0,0,0,0,0,0,0,0,2016
11,20166,GFQ,GFQ,Gulf And Caribbean Cargo,1,0,0,0,0,0,0,176807,98977,275784,0,0,0,0,0,0,346093,202966,549059,2016
11,20402,GL,GL,Miami Air International,2,0,0,0,0,0,0,498351,186027,684378,0,0,0,0,0,0,1062948,396780,1459728,2016
11,19690,HA,HA,Hawaiian Airlines Inc.,3,13202393,0,6325135,0,6325135,19527528,13231712,6325135,19556847,19079324,0,9442790,0,9442790,28522114,19124372,9442790,28567162,2016
11,20310,WL,K8,"Caribbean Sun Airlines, Inc. d/b/a World Atlantic Airlines",1,0,0,0,0,0,0,177716,5970,183686,0,0,0,0,0,0,349777,11750,361527,2016
11,20370,KAQ,KAQ,Kalitta Air LLC,2,0,0,0,0,0,0,1893626,5303960,7197586,0,0,0,0,0,0,2865307,8927799,11793106,2016
11,21629,KD,KD,Western Global,1,0,0,0,0,0,0,923962,1262243,2186205,0,0,0,0,0,0,923962,1262243,2186205,2016
11,21634,KH,KH,Aloha Air Cargo,1,432701,0,0,0,0,432701,432701,0,432701,634092,0,0,0,0,634092,634092,0,634092,2016
11,20372,KLQ,KLQ,Kalitta Charters II,1,0,0,0,0,0,0,150091,7548,157639,0,0,0,0,0,0,325783,16271,342054,2016
11,20169,L2,L2,Lynden Air Cargo Airlines,1,84338,0,0,0,0,84338,144062,21582,165644,147892,0,0,0,0,147892,290750,43504,334254,2016
11,20151,M6,M6,Amerijet International,2,0,0,0,1682262,1682262,1682262,271314,1703396,1974710,0,0,0,2744982,2744982,2744982,442709,2779467,3222176,2016
11,20398,MQ,MQ,Envoy Air,3,0,0,0,0,0,0,0,0,0,0,0,0,0,0,0,0,0,0,2016
11,20405,N8,N8,National Air Cargo Group Inc d/ba National Airlines,1,0,0,0,0,0,0,16426,1817691,1834117,0,0,0,0,0,0,36360,3164431,3200791,2016
11,20108,NC,NC,Northern Air Cargo Inc.,1,365432,0,0,0,0,365432,443537,1156,444693,596644,0,0,0,0,596644,722230,2340,724570,2016
11,20416,NK,NK,Spirit Air Lines,3,23297830,0,0,1916272,1916272,25214102,23297830,1916272,25214102,36642026,0,0,3013846,3013846,39655872,36642026,3013846,39655872,2016
11,20397,OH,OH,PSA Airlines Inc.,2,0,0,0,0,0,0,0,0,0,0,0,0,0,0,0,0,0,0,2016
11,20304,OO,OO,SkyWest Airlines Inc.,3,5341566,0,0,0,0,5341566,5341566,0,5341566,9643922,0,0,0,0,9643922,9643922,0,9643922,2016
11,20177,PFQ,PFQ,Asia Pacific,1,0,0,0,0,0,0,0,333279,333279,0,0,0,0,0,0,0,638003,638003,2016
11,20100,PO,PO,Polar Air Cargo Airways,3,3050947,739433,13095092,0,13834525,16885472,3050947,13834525,16885472,4671263,1379923,19735376,0,21115299,25786562,4671263,21115299,25786562,2016
11,20149,PRQ,PRQ,Florida West Airlines Inc.,1,0,0,0,0,0,0,0,0,0,0,0,0,0,0,0,0,0,0,2016
11,19687,QX,QX,Horizon Air,2,0,0,0,0,0,0,0,0,0,0,0,0,0,0,0,0,0,0,2016
11,20448,S5,S5,Shuttle America Corp.,2,0,0,0,0,0,0,0,0,0,0,0,0,0,0,0,0,0,0,2016
11,20422,SY,SY,Sun Country Airlines d/b/a MN Airlines,2,3286451,0,0,310775,310775,3597226,3934076,385983,4320059,5181706,0,0,503531,503531,5685237,6934078,645276,7579354,2016
11,20447,U7,U7,USA Jet Airlines Inc.,2,0,0,0,0,0,0,413318,2316,415634,0,0,0,0,0,0,649079,5234,654313,2016
11,19977,UA,UA,United Air Lines Inc.,3,120544499,50060534,56254394,23853692,130168620,250713119,121766208,130573185,252339393,172156346,72864344,85615245,36892271,195371860,367528206,173838716,195977367,369816083,2016
11,21171,VX,VX,Virgin America,3,16354903,0,0,175123,175123,16530026,16412225,175123,16587348,23155176,0,0,285004,285004,23440180,23245688,285004,23530692,2016
11,20308,WE,WE,Centurion Cargo Inc.,2,0,0,0,0,0,0,0,357767,357767,0,0,0,0,0,0,0,582292,582292,2016
11,20195,WI,WI,Sky Lease Cargo,1,0,0,0,0,0,0,0,0,0,0,0,0,0,0,0,0,0,0,2016
11,20287,WP,WP,Island Air Hawaii,1,160589,0,0,0,0,160589,160589,0,160589,243396,0,0,0,0,243396,243396,0,243396,2016
11,20377,X9,X9,Omni Air International LLC,2,0,0,0,0,0,0,410850,1742500,2153350,0,0,0,0,0,0,798660,3179291,3977951,2016
11,20207,XP,XP,XTRA Airways,1,0,0,0,0,0,0,428957,110852,539809,0,0,0,0,0,0,853408,220540,1073948,2016
11,20378,YV,YV,Mesa Airlines Inc.,2,0,0,0,0,0,0,0,0,0,0,0,0,0,0,0,0,0,0,2016
11,20452,YX,YX,Republic Airlines,2,0,0,0,0,0,0,0,0,0,0,0,0,0,0,0,0,0,0,2016
11,20046,ZW,ZW,Air Wisconsin Airlines Corp,2,4611,0,0,0,0,4611,4611,0,4611,14673,0,0,0,0,14673,14673,0,14673,2016
11,19393,WN,WN,Southwest Airlines Co.,3,162636836,0,0,1164025,1164025,163800861,162797059,1164025,163961084,295933528,0,0,2176951,2176951,298110479,296169411,2176951,298346362,2016
12,21161,09Q,09Q,"Swift Air, LLC",1,0,0,0,0,0,0,232901,165211,398112,0,0,0,0,0,0,673396,292208,965604,2016
12,21352,0WQ,0WQ,Avjet Corporation,1,0,0,0,0,0,0,24221,0,24221,0,0,0,0,0,0,78476,0,78476,2016
12,21492,1BQ,1BQ,"Dynamic Airways, LLC",1,0,0,0,0,0,0,12355,288132,300487,0,0,0,0,0,0,40825,954917,995742,2016
12,21645,23Q,23Q,Songbird Airways Inc.,1,0,0,0,0,0,0,5116,109766,114882,0,0,0,0,0,0,13338,237422,250760,2016
12,21652,27Q,27Q,"Jet Aviation Flight Services, Inc.",1,0,0,0,0,0,0,0,0,0,0,0,0,0,0,0,0,0,0,2016
12,20408,5V,5V,Tatonduk Outfitters Limited d/b/a Everts Air Alaska and Everts Air Cargo,1,254634,0,0,0,0,254634,363025,0,363025,589423,0,0,0,0,589423,840325,0,840325,2016
12,19917,5X,5X,United Parcel Service,3,51475000,10421000,18652000,2604000,31677000,83152000,51475000,31677000,83152000,79139000,13866000,26546000,4263000,44675000,123814000,79139000,44675000,123814000,2016
12,20007,5Y,5Y,Atlas Air Inc.,3,0,0,0,0,0,0,9034696,24812640,33847336,0,0,0,0,0,0,15033033,41730677,56763710,2016
12,19874,8C,8C,Air Transport International,2,0,0,0,0,0,0,94822,637512,732334,0,0,0,0,0,0,205682,1279713,1485395,2016
12,20363,9E,9E,Endeavor Air Inc.,2,0,0,0,0,0,0,0,0,0,0,0,0,0,0,0,0,0,0,2016
12,20190,9S,9S,Southern Air Inc.,2,910955,4699263,626724,0,5325987,6236942,910955,5325987,6236942,1913006,9868453,1316119,0,11184572,13097578,1913006,11184572,13097578,2016
12,19805,AA,AA,American Airlines Inc.,3,180929810,39132363,23140514,50997523,113270400,294200210,181550822,113430747,294981569,270264067,58432135,35082663,80320904,173835702,444099769,271180046,174095077,445275123,2016
12,20453,ABX,ABX,ABX Air Inc,2,31953,0,0,0,0,31953,31953,0,31953,52722,0,0,0,0,52722,52722,0,52722,2016
12,19930,AS,AS,Alaska Airlines Inc.,3,39121535,0,0,891376,891376,40012911,39194602,891376,40085978,66395426,0,0,1580523,1580523,67975949,66505091,1580523,68085614,2016
12,20409,B6,B6,JetBlue Airways,3,53163032,0,0,13511900,13511900,66674932,53163032,13511900,66674932,84585953,0,0,21498340,21498340,106084293,84585953,21498340,106084293,2016
12,21167,CP,CP,Compass Airlines,2,0,0,0,0,0,0,0,0,0,0,0,0,0,0,0,0,0,0,2016
12,19790,DL,DL,Delta Air Lines Inc.,3,158940167,47541958,31642327,26398392,105582677,264522844,161052592,105656645,266709237,258757283,77399113,51514244,42977029,171890386,430647669,263321066,172010806,435331872,2016
12,21650,EE,EE,Eastern Airlines Group Inc.,1,0,0,0,0,0,0,169520,361840,531360,0,0,0,0,0,0,310222,662167,972389,2016
12,20366,EV,EV,ExpressJet Airlines Inc.,3,85946,0,0,0,0,85946,85946,0,85946,239935,0,0,0,0,239935,239935,0,239935,2016
12,20436,F9,F9,Frontier Airlines Inc.,3,17463011,0,0,1414406,1414406,18877417,17463793,1414406,18878199,25865611,0,0,2361713,2361713,28227324,25867247,2361713,28228960,2016
12,20107,FX,FX,Federal Express Corporation,3,74253963,10470499,19941851,1705671,32118021,106371984,76008582,32330611,108339193,111023000,16289000,29967000,2841000,49097000,160120000,113705000,49425000,163130000,2016
12,20368,G4,G4,Allegiant Air,3,15292583,0,0,0,0,15292583,15863821,0,15863821,26838285,0,0,0,0,26838285,27856572,0,27856572,2016
12,20500,G7,G7,GoJet Airlines LLC d/b/a United Express,2,0,0,0,0,0,0,0,0,0,0,0,0,0,0,0,0,0,0,2016
12,20166,GFQ,GFQ,Gulf And Caribbean Cargo,1,0,0,0,0,0,0,239187,81263,320450,0,0,0,0,0,0,483211,170128,653339,2016
12,20402,GL,GL,Miami Air International,2,0,0,0,0,0,0,321166,132839,454005,0,0,0,0,0,0,723520,299259,1022779,2016
12,19690,HA,HA,Hawaiian Airlines Inc.,3,14497178,0,7096263,0,7096263,21593441,14541358,7096263,21637621,22338650,0,10693659,0,10693659,33032309,22405322,10693659,33098981,2016
12,20310,WL,K8,"Caribbean Sun Airlines, Inc. d/b/a World Atlantic Airlines",1,0,0,0,0,0,0,226314,8642,234956,0,0,0,0,0,0,396884,17657,414541,2016
12,20370,KAQ,KAQ,Kalitta Air LLC,2,0,0,0,0,0,0,2719396,2573836,5293232,0,0,0,0,0,0,4162745,4406772,8569517,2016
12,21629,KD,KD,Western Global,1,0,0,0,0,0,0,525016,908181,1433197,0,0,0,0,0,0,1108182,1939280,3047462,2016
12,21634,KH,KH,Aloha Air Cargo,1,478937,0,0,0,0,478937,478937,0,478937,750888,0,0,0,0,750888,750888,0,750888,2016
12,20372,KLQ,KLQ,Kalitta Charters II,1,0,0,0,0,0,0,108732,19981,128713,0,0,0,0,0,0,262669,49340,312009,2016
12,20169,L2,L2,Lynden Air Cargo Airlines,1,76390,0,0,0,0,76390,133882,7653,141535,136776,0,0,0,0,136776,282536,16178,298714,2016
12,20151,M6,M6,Amerijet International,2,0,0,0,1841078,1841078,1841078,295361,2154944,2450305,0,0,0,3187181,3187181,3187181,511314,3730530,4241844,2016
12,20398,MQ,MQ,Envoy Air,3,0,0,0,0,0,0,0,0,0,0,0,0,0,0,0,0,0,0,2016
12,20405,N8,N8,National Air Cargo Group Inc d/ba National Airlines,1,0,0,0,0,0,0,48783,1122726,1171509,0,0,0,0,0,0,106844,2071127,2177971,2016
12,20108,NC,NC,Northern Air Cargo Inc.,1,349447,0,0,0,0,349447,496392,9720,506112,611881,0,0,0,0,611881,882663,19988,902651,2016
12,20416,NK,NK,Spirit Air Lines,3,25917939,0,0,1079914,1079914,26997853,25917939,1079914,26997853,43979705,0,0,1832488,1832488,45812193,43979705,1832488,45812193,2016
12,20397,OH,OH,PSA Airlines Inc.,2,0,0,0,0,0,0,0,0,0,0,0,0,0,0,0,0,0,0,2016
12,20304,OO,OO,SkyWest Airlines Inc.,3,5655072,0,0,0,0,5655072,5655072,0,5655072,10848121,0,0,0,0,10848121,10848121,0,10848121,2016
12,20177,PFQ,PFQ,Asia Pacific,1,0,0,0,0,0,0,0,452769,452769,0,0,0,0,0,0,0,846521,846521,2016
12,20100,PO,PO,Polar Air Cargo Airways,3,3306987,744155,13424293,0,14168448,17475435,3306987,14168448,17475435,5159454,1445738,18885343,0,20331081,25490535,5159454,20331081,25490535,2016
12,20149,PRQ,PRQ,Florida West Airlines Inc.,1,0,0,0,0,0,0,0,0,0,0,0,0,0,0,0,0,0,0,2016
12,19687,QX,QX,Horizon Air,2,0,0,0,0,0,0,0,0,0,0,0,0,0,0,0,0,0,0,2016
12,20448,S5,S5,Shuttle America Corp.,2,0,0,0,0,0,0,0,0,0,0,0,0,0,0,0,0,0,0,2016
12,20422,SY,SY,Sun Country Airlines d/b/a MN Airlines,2,3946626,0,0,844123,844123,4790749,4394891,935347,5330238,6665124,0,0,1547745,1547745,8212869,7726423,1700367,9426790,2016
12,20447,U7,U7,USA Jet Airlines Inc.,2,0,0,0,0,0,0,614476,3639,618115,0,0,0,0,0,0,1023164,8370,1031534,2016
12,19977,UA,UA,United Air Lines Inc.,3,128349333,51285933,59285698,32506837,143078468,271427801,129678635,143602235,273280870,192689748,77106850,89852953,51997178,218956981,411646729,195282413,219766732,415049145,2016
12,21171,VX,VX,Virgin America,3,16217338,0,0,201622,201622,16418960,16849476,201622,17051098,24553771,0,0,343679,343679,24897450,25546139,343679,25889818,2016
12,20308,WE,WE,Centurion Cargo Inc.,2,0,0,0,0,0,0,0,357767,357767,0,0,0,0,0,0,0,582292,582292,2016
12,20195,WI,WI,Sky Lease Cargo,1,0,0,0,0,0,0,0,0,0,0,0,0,0,0,0,0,0,0,2016
12,20287,WP,WP,Island Air Hawaii,1,165446,0,0,0,0,165446,165446,0,165446,252375,0,0,0,0,252375,252375,0,252375,2016
12,20377,X9,X9,Omni Air International LLC,2,0,0,0,0,0,0,370131,1804685,2174816,0,0,0,0,0,0,669423,3483902,4153325,2016
12,20207,XP,XP,XTRA Airways,1,0,0,0,0,0,0,392538,175953,568491,0,0,0,0,0,0,780952,350058,1131010,2016
12,20378,YV,YV,Mesa Airlines Inc.,2,0,0,0,0,0,0,0,0,0,0,0,0,0,0,0,0,0,0,2016
12,20452,YX,YX,Republic Airlines,2,0,0,0,0,0,0,0,0,0,0,0,0,0,0,0,0,0,0,2016
12,20046,ZW,ZW,Air Wisconsin Airlines Corp,2,7716,0,0,0,0,7716,7716,0,7716,24699,0,0,0,0,24699,24699,0,24699,2016
12,19393,WN,WN,Southwest Airlines Co.,3,168670614,0,0,1581759,1581759,170252373,168866327,1581759,170448086,309413568,0,0,3017318,3017318,312430886,309724573,3017318,312741891,2016
1,21161,09Q,09Q,"Swift Air, LLC",1,0,0,0,0,0,0,256774,95831,352605,0,0,0,0,0,0,809790,168157,977947,2017
1,21352,0WQ,0WQ,Avjet Corporation,1,0,0,0,0,0,0,21569,4449,26018,0,0,0,0,0,0,66217,15041,81258,2017
1,21492,1BQ,1BQ,"Dynamic Airways, LLC",1,0,0,0,0,0,0,4597,214712,219309,0,0,0,0,0,0,32362,1508670,1541032,2017
1,21645,23Q,23Q,Songbird Airways Inc.,1,0,0,0,0,0,0,2013,80888,82901,0,0,0,0,0,0,4005,160926,164931,2017
1,21652,27Q,27Q,"Jet Aviation Flight Services, Inc.",1,0,0,0,0,0,0,0,0,0,0,0,0,0,0,0,0,0,0,2017
1,20408,5V,5V,Tatonduk Outfitters Limited d/b/a Everts Air Alaska and Everts Air Cargo,1,288080,0,0,0,0,288080,343787,0,343787,640228,0,0,0,0,640228,764031,0,764031,2017
1,19917,5X,5X,United Parcel Service,3,34644000,10416000,16379000,2940000,29735000,64379000,34644000,29735000,64379000,53132000,13782000,23341000,4811000,41934000,95066000,53132000,41934000,95066000,2017
1,20007,5Y,5Y,Atlas Air Inc.,3,0,0,0,0,0,0,6480235,24055137,30535372,0,0,0,0,0,0,12025032,43357114,55382146,2017
1,19874,8C,8C,Air Transport International,2,0,0,0,0,0,0,47241,555302,602543,0,0,0,0,0,0,59783,1064685,1124468,2017
1,20363,9E,9E,Endeavor Air Inc.,2,0,0,0,0,0,0,0,0,0,0,0,0,0,0,0,0,0,0,2017
1,20190,9S,9S,Southern Air Inc.,2,718335,4203058,530133,0,4733191,5451526,718335,4733191,5451526,1508503,8826422,1113279,0,9939701,11448204,1508503,9939701,11448204,2017
1,19805,AA,AA,American Airlines Inc.,3,173469401,33206328,24149194,49782778,107138300,280607701,174090394,107455774,281546168,266034459,52883341,38300249,82143269,173326859,439361318,267005785,173882538,440888323,2017
1,20453,ABX,ABX,ABX Air Inc,2,17328,0,0,0,0,17328,17328,0,17328,29284,0,0,0,0,29284,29284,0,29284,2017
1,19930,AS,AS,Alaska Airlines Inc.,3,39039714,0,0,759544,759544,39799258,39098220,759544,39857764,68342738,0,0,1406341,1406341,69749079,68433988,1406341,69840329,2017
1,20409,B6,B6,JetBlue Airways,3,52616464,0,0,12623355,12623355,65239819,52620184,12623355,65243539,88820941,0,0,21309267,21309267,110130208,88828064,21309267,110137331,2017
1,21167,CP,CP,Compass Airlines,2,0,0,0,0,0,0,0,0,0,0,0,0,0,0,0,0,0,0,2017
1,19790,DL,DL,Delta Air Lines Inc.,3,150473387,44131080,32347693,29282078,105760851,256234238,152284041,105902941,258186982,250418287,73443082,53833134,48731327,176007543,426425830,254460963,176244009,430704972,2017
1,21650,EE,EE,Eastern Airlines Group Inc.,1,0,0,0,0,0,0,148320,279440,427760,0,0,0,0,0,0,280325,528142,808467,2017
1,20366,EV,EV,ExpressJet Airlines Inc.,3,87798,0,0,0,0,87798,87798,0,87798,241962,0,0,0,0,241962,241962,0,241962,2017
1,20436,F9,F9,Frontier Airlines Inc.,3,17285649,0,0,1581768,1581768,18867417,17288699,1581768,18870467,26865074,0,0,2667264,2667264,29532338,26871434,2667264,29538698,2017
1,20107,FX,FX,Federal Express Corporation,3,56840294,11705353,18691628,1936777,32333758,89174052,58142242,32953989,91096231,89360000,19233000,30560000,3384000,53177000,142537000,91498000,54335000,145833000,2017
1,20368,G4,G4,Allegiant Air,3,13670041,0,0,0,0,13670041,14466463,0,14466463,24628856,0,0,0,0,24628856,26151460,0,26151460,2017
1,20500,G7,G7,GoJet Airlines LLC d/b/a United Express,2,0,0,0,0,0,0,0,0,0,0,0,0,0,0,0,0,0,0,2017
1,20166,GFQ,GFQ,Gulf And Caribbean Cargo,1,0,0,0,0,0,0,72400,96485,168885,0,0,0,0,0,0,152176,211456,363632,2017
1,20402,GL,GL,Miami Air International,2,0,0,0,0,0,0,340111,367649,707760,0,0,0,0,0,0,741648,804181,1545829,2017
1,19690,HA,HA,Hawaiian Airlines Inc.,3,14146777,0,7342205,0,7342205,21488982,14166464,7342205,21508669,22743910,0,11956007,0,11956007,34699917,22776163,11956007,34732170,2017
1,20310,WL,K8,"Caribbean Sun Airlines, Inc. d/b/a World Atlantic Airlines",1,0,0,0,0,0,0,82209,12299,94508,0,0,0,0,0,0,173913,26018,199931,2017
1,20370,KAQ,KAQ,Kalitta Air LLC,2,0,0,0,0,0,0,547707,3026276,3573983,0,0,0,0,0,0,904665,5560123,6464788,2017
1,21629,KD,KD,Western Global,1,0,0,0,0,0,0,313863,342172,656035,0,0,0,0,0,0,635754,687321,1323075,2017
1,21634,KH,KH,Aloha Air Cargo,1,436860,0,0,0,0,436860,436860,0,436860,723082,0,0,0,0,723082,723082,0,723082,2017
1,20372,KLQ,KLQ,Kalitta Charters II,1,0,0,0,0,0,0,69542,38921,108463,0,0,0,0,0,0,145734,90451,236185,2017
1,20169,L2,L2,Lynden Air Cargo Airlines,1,79040,0,0,0,0,79040,168849,16907,185756,186411,0,0,0,0,186411,420337,26124,446461,2017
1,20151,M6,M6,Amerijet International,2,0,0,0,1424029,1424029,1424029,196716,1424029,1620745,0,0,0,2577590,2577590,2577590,356069,2577590,2933659,2017
1,20398,MQ,MQ,Envoy Air,3,0,0,0,0,0,0,0,0,0,0,0,0,0,0,0,0,0,0,2017
1,20405,N8,N8,National Air Cargo Group Inc d/ba National Airlines,1,0,0,0,0,0,0,130949,1112308,1243257,0,0,0,0,0,0,308864,2269013,2577877,2017
1,20108,NC,NC,Northern Air Cargo Inc.,1,330977,0,0,0,0,330977,365193,1235,366428,604311,0,0,0,0,604311,655609,2324,657933,2017
1,20416,NK,NK,Spirit Air Lines,3,24523033,0,0,2103496,2103496,26626529,24523033,2103496,26626529,42391182,0,0,3636160,3636160,46027342,42391182,3636160,46027342,2017
1,20397,OH,OH,PSA Airlines Inc.,2,0,0,0,0,0,0,0,0,0,0,0,0,0,0,0,0,0,0,2017
1,20304,OO,OO,SkyWest Airlines Inc.,3,5631031,0,0,0,0,5631031,5631031,0,5631031,11005676,0,0,0,0,11005676,11005676,0,11005676,2017
1,20177,PFQ,PFQ,Asia Pacific,1,0,0,0,0,0,0,0,287340,287340,0,0,0,0,0,0,0,540515,540515,2017
1,20100,PO,PO,Polar Air Cargo Airways,3,2972233,706618,12426063,0,13132681,16104914,2972233,13132681,16104914,4932681,1381548,19169925,0,20551473,25484154,4932681,20551473,25484154,2017
1,20149,PRQ,PRQ,Florida West Airlines Inc.,1,0,0,0,0,0,0,0,0,0,0,0,0,0,0,0,0,0,0,2017
1,19687,QX,QX,Horizon Air,2,0,0,0,0,0,0,0,0,0,0,0,0,0,0,0,0,0,0,2017
1,20422,SY,SY,Sun Country Airlines d/b/a MN Airlines,2,3244005,0,0,1610803,1610803,4854808,3884944,1714785,5599729,5683184,0,0,2989805,2989805,8672989,6660467,3155260,9815727,2017
1,20447,U7,U7,USA Jet Airlines Inc.,2,0,0,0,0,0,0,277568,6307,283875,0,0,0,0,0,0,482968,15157,498125,2017
1,19977,UA,UA,United Air Lines Inc.,3,114135421,50681127,56129894,32327378,139138399,253273820,115242670,139805649,255048319,181090577,81595787,92134732,54909181,228639700,409730277,182772832,229727957,412500789,2017
1,21171,VX,VX,Virgin America,3,15375472,0,0,176095,176095,15551567,15928312,176095,16104407,24081055,0,0,314887,314887,24395942,24994366,314887,25309253,2017
1,20195,WI,WI,Sky Lease Cargo,1,0,0,0,0,0,0,0,0,0,0,0,0,0,0,0,0,0,0,2017
1,20287,WP,WP,Island Air Hawaii,1,195365,0,0,0,0,195365,195365,0,195365,329664,0,0,0,0,329664,329664,0,329664,2017
1,20377,X9,X9,Omni Air International LLC,2,0,0,0,0,0,0,481822,2856741,3338563,0,0,0,0,0,0,880829,5972428,6853257,2017
1,20207,XP,XP,XTRA Airways,1,0,0,0,0,0,0,359944,339349,699293,0,0,0,0,0,0,716107,675133,1391240,2017
1,20378,YV,YV,Mesa Airlines Inc.,2,0,0,0,0,0,0,0,0,0,0,0,0,0,0,0,0,0,0,2017
1,20452,YX,YX,Republic Airline,2,0,0,0,0,0,0,0,0,0,0,0,0,0,0,0,0,0,0,2017
1,20046,ZW,ZW,Air Wisconsin Airlines Corp,2,3636,0,0,0,0,3636,3636,0,3636,12151,0,0,0,0,12151,12151,0,12151,2017
1,19393,WN,WN,Southwest Airlines Co.,3,162137430,0,0,1327699,1327699,163465129,162340545,1327699,163668244,288113764,0,0,2697338,2697338,290811102,288448797,2697338,291146135,2017
2,21161,09Q,09Q,"Swift Air, LLC",1,0,0,0,0,0,0,265742,84337,350079,0,0,0,0,0,0,702645,195137,897782,2017
2,21352,0WQ,0WQ,Avjet Corporation,1,0,0,0,0,0,0,21244,0,21244,0,0,0,0,0,0,66921,0,66921,2017
2,21492,1BQ,1BQ,"Dynamic Airways, LLC",1,0,0,0,0,0,0,7185,165616,172801,0,0,0,0,0,0,31217,712035,743252,2017
2,21645,23Q,23Q,Songbird Airways Inc.,1,0,0,0,0,0,0,3594,11861,15455,0,0,0,0,0,0,7150,23597,30747,2017
2,21652,27Q,27Q,"Jet Aviation Flight Services, Inc.",1,0,0,0,0,0,0,0,0,0,0,0,0,0,0,0,0,0,0,2017
2,20408,5V,5V,Tatonduk Outfitters Limited d/b/a Everts Air Alaska and Everts Air Cargo,1,233940,0,0,0,0,233940,320791,0,320791,564034,0,0,0,0,564034,773434,0,773434,2017
2,19917,5X,5X,United Parcel Service,3,31215000,8565000,12080000,2887000,23532000,54747000,31215000,23532000,54747000,50872000,12045000,19250000,5036000,36331000,87203000,50872000,36331000,87203000,2017
2,20007,5Y,5Y,Atlas Air Inc.,3,0,0,0,0,0,0,5198635,19641954,24840589,0,0,0,0,0,0,9740436,36097650,45838086,2017
2,19874,8C,8C,Air Transport International,2,0,0,0,0,0,0,34785,565956,600741,0,0,0,0,0,0,69584,1085667,1155251,2017
2,20363,9E,9E,Endeavor Air Inc.,2,0,0,0,0,0,0,0,0,0,0,0,0,0,0,0,0,0,0,2017
2,20190,9S,9S,Southern Air Inc.,2,631507,4138384,526182,0,4664566,5296073,631507,4664566,5296073,1326164,8690606,1144982,0,9835588,11161752,1326164,9835588,11161752,2017
2,19805,AA,AA,American Airlines Inc.,3,156839137,28742778,21749711,43907183,94399672,251238809,157287982,94643568,251931550,247341413,46711539,35259724,75274634,157245897,404587310,248053440,157656987,405710427,2017
2,20453,ABX,ABX,ABX Air Inc,2,16484,0,0,0,0,16484,16484,0,16484,31949,0,0,0,0,31949,31949,0,31949,2017
2,19930,AS,AS,Alaska Airlines Inc.,3,34995189,0,0,721790,721790,35716979,35037875,721790,35759665,62609829,0,0,1334416,1334416,63944245,62678787,1334416,64013203,2017
2,20409,B6,B6,JetBlue Airways,3,47241858,0,0,11089653,11089653,58331511,47246508,11089653,58336161,80621726,0,0,18925313,18925313,99547039,80630770,18925313,99556083,2017
2,21167,CP,CP,Compass Airlines,2,0,0,0,0,0,0,0,0,0,0,0,0,0,0,0,0,0,0,2017
2,19790,DL,DL,Delta Air Lines Inc.,3,139784428,37038875,28239571,25770663,91049109,230833537,141386742,91207330,232594072,251049714,66520994,50717639,46283537,163522170,414571884,254905563,163806330,418711893,2017
2,21650,EE,EE,Eastern Airlines Group Inc.,1,0,0,0,0,0,0,195280,244640,439920,0,0,0,0,0,0,382749,479494,862243,2017
2,20366,EV,EV,ExpressJet Airlines Inc.,3,81082,0,0,0,0,81082,81082,0,81082,232197,0,0,0,0,232197,232197,0,232197,2017
2,20436,F9,F9,Frontier Airlines Inc.,3,15078298,0,0,1448602,1448602,16526900,15078298,1448602,16526900,23575186,0,0,2471984,2471984,26047170,23575186,2471984,26047170,2017
2,20107,FX,FX,Federal Express Corporation,3,54301494,11172451,15702259,1881171,28755881,83057375,55439394,29388944,84828338,86574000,18480000,26151000,3403000,48034000,134608000,88442339,49295000,137737339,2017
2,20368,G4,G4,Allegiant Air,3,13489516,0,0,0,0,13489516,14160937,0,14160937,24668034,0,0,0,0,24668034,25981537,0,25981537,2017
2,20500,G7,G7,GoJet Airlines LLC d/b/a United Express,2,0,0,0,0,0,0,0,0,0,0,0,0,0,0,0,0,0,0,2017
2,20166,GFQ,GFQ,Gulf And Caribbean Cargo,1,0,0,0,0,0,0,186379,81737,268116,0,0,0,0,0,0,409305,187939,597244,2017
2,20402,GL,GL,Miami Air International,2,0,0,0,0,0,0,316608,254322,570930,0,0,0,0,0,0,706381,567415,1273796,2017
2,19690,HA,HA,Hawaiian Airlines Inc.,3,12544537,0,6376526,0,6376526,18921063,12544537,6376526,18921063,20326816,0,10447290,0,10447290,30774106,20326816,10447290,30774106,2017
2,20310,WL,K8,"Caribbean Sun Airlines, Inc. d/b/a World Atlantic Airlines",1,0,0,0,0,0,0,68463,187687,256150,0,0,0,0,0,0,49753,136393,186146,2017
2,20370,KAQ,KAQ,Kalitta Air LLC,2,0,0,0,0,0,0,325001,2521292,2846293,0,0,0,0,0,0,564981,4800028,5365009,2017
2,21629,KD,KD,Western Global,1,0,0,0,0,0,0,115340,250705,366045,0,0,0,0,0,0,262337,491142,753479,2017
2,21634,KH,KH,Aloha Air Cargo,1,406852,0,0,0,0,406852,406852,0,406852,675557,0,0,0,0,675557,675557,0,675557,2017
2,20372,KLQ,KLQ,Kalitta Charters II,1,0,0,0,0,0,0,202439,2745,205184,0,0,0,0,0,0,469427,7219,476646,2017
2,20169,L2,L2,Lynden Air Cargo Airlines,1,77839,0,0,0,0,77839,104445,17775,122220,156952,0,0,0,0,156952,220721,41949,262670,2017
2,20151,M6,M6,Amerijet International,2,0,0,0,1426777,1426777,1426777,214039,1432822,1646861,0,0,0,2573311,2573311,2573311,386037,2584214,2970251,2017
2,20398,MQ,MQ,Envoy Air,3,0,0,0,0,0,0,0,0,0,0,0,0,0,0,0,0,0,0,2017
2,20405,N8,N8,National Air Cargo Group Inc d/ba National Airlines,1,0,0,0,0,0,0,249616,641397,891013,0,0,0,0,0,0,644218,1260304,1904522,2017
2,20108,NC,NC,Northern Air Cargo Inc.,1,307901,0,0,0,0,307901,347703,0,347703,570080,0,0,0,0,570080,637568,0,637568,2017
2,20416,NK,NK,Spirit Air Lines,3,22653257,0,0,1943113,1943113,24596370,22653257,1943113,24596370,41752070,0,0,3581339,3581339,45333409,41752070,3581339,45333409,2017
2,20397,OH,OH,PSA Airlines Inc.,2,0,0,0,0,0,0,0,0,0,0,0,0,0,0,0,0,0,0,2017
2,20304,OO,OO,SkyWest Airlines Inc.,3,5229066,0,0,0,0,5229066,5229066,0,5229066,10371801,0,0,0,0,10371801,10371801,0,10371801,2017
2,20177,PFQ,PFQ,Asia Pacific,1,0,0,0,0,0,0,0,267200,267200,0,0,0,0,0,0,0,559539,559539,2017
2,20100,PO,PO,Polar Air Cargo Airways,3,2576212,487911,10595115,0,11083026,13659238,2576212,11083026,13659238,4266025,966763,16852759,0,17819522,22085547,4266025,17819522,22085547,2017
2,20149,PRQ,PRQ,Florida West Airlines Inc.,1,0,0,0,0,0,0,0,0,0,0,0,0,0,0,0,0,0,0,2017
2,19687,QX,QX,Horizon Air,2,0,0,0,0,0,0,0,0,0,0,0,0,0,0,0,0,0,0,2017
2,20422,SY,SY,Sun Country Airlines d/b/a MN Airlines,2,2990468,0,0,2101991,2101991,5092459,3395917,2264961,5660878,5311935,0,0,4008995,4008995,9320930,6643017,4340099,10983116,2017
2,20447,U7,U7,USA Jet Airlines Inc.,2,0,0,0,0,0,0,266066,1476,267542,0,0,0,0,0,0,470937,3616,474553,2017
2,19977,UA,UA,United Air Lines Inc.,3,104880278,44432245,52040151,27412507,123884903,228765181,106044579,124507628,230552207,168396647,71689039,85950446,46694492,204333977,372730624,170922024,205381093,376303117,2017
2,21171,VX,VX,Virgin America,3,13559118,0,0,147373,147373,13706491,13829887,147373,13977260,21611587,0,0,265065,265065,21876652,22065760,265065,22330825,2017
2,20195,WI,WI,Sky Lease Cargo,1,0,0,0,0,0,0,0,0,0,0,0,0,0,0,0,0,0,0,2017
2,20287,WP,WP,Island Air Hawaii,1,207976,0,0,0,0,207976,207976,0,207976,367638,0,0,0,0,367638,367638,0,367638,2017
2,20377,X9,X9,Omni Air International LLC,2,0,0,0,0,0,0,469749,2719603,3189352,0,0,0,0,0,0,1031048,4565266,5596314,2017
2,20207,XP,XP,XTRA Airways,1,0,0,0,0,0,0,195487,266959,462446,0,0,0,0,0,0,388920,531114,920034,2017
2,20378,YV,YV,Mesa Airlines Inc.,2,0,0,0,0,0,0,0,0,0,0,0,0,0,0,0,0,0,0,2017
2,20452,YX,YX,Republic Airline,2,0,0,0,0,0,0,0,0,0,0,0,0,0,0,0,0,0,0,2017
2,20046,ZW,ZW,Air Wisconsin Airlines Corp,2,4302,0,0,0,0,4302,4302,0,4302,13989,0,0,0,0,13989,13989,0,13989,2017
2,19393,WN,WN,Southwest Airlines Co.,3,144701548,0,0,1357313,1357313,146058861,144819523,1357313,146176836,266325812,0,0,2756387,2756387,269082199,266514157,2756387,269270544,2017
3,21161,09Q,09Q,"Swift Air, LLC",1,0,0,0,0,0,0,518628,117966,636594,0,0,0,0,0,0,1355814,212335,1568149,2017
3,21352,0WQ,0WQ,Avjet Corporation,1,0,0,0,0,0,0,25331,1740,27071,0,0,0,0,0,0,83338,4072,87410,2017
3,21492,1BQ,1BQ,"Dynamic Airways, LLC",1,0,0,0,0,0,0,3381,145325,148706,0,0,0,0,0,0,19298,819736,839034,2017
3,21645,23Q,23Q,Songbird Airways Inc.,1,0,0,0,0,0,0,0,0,0,0,0,0,0,0,0,0,0,0,2017
3,21652,27Q,27Q,"Jet Aviation Flight Services, Inc.",1,0,0,0,0,0,0,0,0,0,0,0,0,0,0,0,0,0,0,2017
3,20408,5V,5V,Tatonduk Outfitters Limited d/b/a Everts Air Alaska and Everts Air Cargo,1,326993,0,0,0,0,326993,428332,0,428332,763434,0,0,0,0,763434,1000031,0,1000031,2017
3,19917,5X,5X,United Parcel Service,3,36362000,10681000,17762000,2985000,31428000,67790000,36362000,31428000,67790000,57057000,14962000,28044000,5104000,48110000,105167000,57057000,48110000,105167000,2017
3,20007,5Y,5Y,Atlas Air Inc.,3,0,0,0,0,0,0,6946147,24811003,31757150,0,0,0,0,0,0,13063892,45057028,58120920,2017
3,19874,8C,8C,Air Transport International,2,0,0,0,0,0,0,22706,589475,612181,0,0,0,0,0,0,50475,1137003,1187478,2017
3,20363,9E,9E,Endeavor Air Inc.,2,0,0,0,0,0,0,0,0,0,0,0,0,0,0,0,0,0,0,2017
3,20190,9S,9S,Southern Air Inc.,2,913028,4812645,659063,0,5471708,6384736,913028,5471708,6384736,1917359,10106555,1384032,0,11490587,13407946,1917359,11490587,13407946,2017
3,19805,AA,AA,American Airlines Inc.,3,184642527,38327738,24336440,49969748,112633926,297276453,185203987,112776350,297980337,285711849,60946085,38788037,83837769,183571891,469283740,286585329,183814102,470399431,2017
3,20453,ABX,ABX,ABX Air Inc,2,24522,0,0,0,0,24522,24522,0,24522,43887,0,0,0,0,43887,43887,0,43887,2017
3,19930,AS,AS,Alaska Airlines Inc.,3,41646150,0,0,814614,814614,42460764,41707157,814614,42521771,73390957,0,0,1454849,1454849,74845806,73488764,1454849,74943613,2017
3,20409,B6,B6,JetBlue Airways,3,54802868,0,0,12465751,12465751,67268619,54828098,12465751,67293849,91972857,0,0,20920633,20920633,112893490,92005424,20920633,112926057,2017
3,21167,CP,CP,Compass Airlines,2,0,0,0,0,0,0,0,0,0,0,0,0,0,0,0,0,0,0,2017
3,19790,DL,DL,Delta Air Lines Inc.,3,171602498,47543994,31800476,29472594,108817064,280419562,173731457,108916061,282647518,287235213,79581063,53228925,49332422,182142410,469377623,291972249,182308117,474280366,2017
3,21650,EE,EE,Eastern Airlines Group Inc.,1,0,0,0,0,0,0,216240,304240,520480,0,0,0,0,0,0,395719,556759,952478,2017
3,20366,EV,EV,ExpressJet Airlines Inc.,3,94607,0,0,0,0,94607,94607,0,94607,257077,0,0,0,0,257077,257077,0,257077,2017
3,20436,F9,F9,Frontier Airlines Inc.,3,17167354,0,0,1622777,1622777,18790131,17167354,1622777,18790131,26067753,0,0,2698128,2698128,28765881,26067753,2698128,28765881,2017
3,20107,FX,FX,Federal Express Corporation,3,63700012,12843578,20386031,2195456,35425065,99125077,65096201,36185568,101281769,97990000,20563000,33855000,4004000,58422000,156412000,100164429,59862397,160026826,2017
3,20368,G4,G4,Allegiant Air,3,17445442,0,0,0,0,17445442,18222665,0,18222665,30881770,0,0,0,0,30881770,32316022,0,32316022,2017
3,20500,G7,G7,GoJet Airlines LLC d/b/a United Express,2,0,0,0,0,0,0,0,0,0,0,0,0,0,0,0,0,0,0,2017
3,20166,GFQ,GFQ,Gulf And Caribbean Cargo,1,0,0,0,0,0,0,153648,150260,303908,0,0,0,0,0,0,312181,329598,641779,2017
3,20402,GL,GL,Miami Air International,2,0,0,0,0,0,0,438379,348136,786515,0,0,0,0,0,0,1004239,797510,1801749,2017
3,19690,HA,HA,Hawaiian Airlines Inc.,3,14071549,0,7236428,0,7236428,21307977,14071549,7236428,21307977,22225149,0,11709920,0,11709920,33935069,22225149,11709920,33935069,2017
3,20310,WL,K8,"Caribbean Sun Airlines, Inc. d/b/a World Atlantic Airlines",1,0,0,0,0,0,0,29956,223731,253687,0,0,0,0,0,0,15757,117686,133443,2017
3,20370,KAQ,KAQ,Kalitta Air LLC,2,0,0,0,0,0,0,634541,2806025,3440566,0,0,0,0,0,0,983544,5251197,6234741,2017
3,21629,KD,KD,Western Global,1,0,0,0,0,0,0,497954,1102514,1600468,0,0,0,0,0,0,1033416,2122936,3156352,2017
3,21634,KH,KH,Aloha Air Cargo,1,447281,0,0,0,0,447281,447281,0,447281,718601,0,0,0,0,718601,718601,0,718601,2017
3,20372,KLQ,KLQ,Kalitta Charters II,1,0,0,0,0,0,0,122615,43945,166560,0,0,0,0,0,0,280014,97161,377175,2017
3,20169,L2,L2,Lynden Air Cargo Airlines,1,94398,0,0,0,0,94398,136075,0,136075,180235,0,0,0,0,180235,285150,0,285150,2017
3,20151,M6,M6,Amerijet International,2,0,0,0,1555590,1555590,1555590,266851,1567321,1834172,0,0,0,2712666,2712666,2712666,465339,2733123,3198462,2017
3,20398,MQ,MQ,Envoy Air,3,0,0,0,0,0,0,0,0,0,0,0,0,0,0,0,0,0,0,2017
3,20405,N8,N8,National Air Cargo Group Inc d/ba National Airlines,1,0,0,0,0,0,0,284779,890393,1175172,0,0,0,0,0,0,714492,1822680,2537172,2017
3,20108,NC,NC,Northern Air Cargo Inc.,1,390578,0,0,0,0,390578,476781,6592,483373,694274,0,0,0,0,694274,837509,11824,849333,2017
3,20416,NK,NK,Spirit Air Lines,3,25669048,0,0,2171568,2171568,27840616,25669048,2171568,27840616,44644241,0,0,3776845,3776845,48421086,44644241,3776845,48421086,2017
3,20397,OH,OH,PSA Airlines Inc.,2,0,0,0,0,0,0,0,0,0,0,0,0,0,0,0,0,0,0,2017
3,20304,OO,OO,SkyWest Airlines Inc.,3,6327013,0,0,0,0,6327013,6327013,0,6327013,12209334,0,0,0,0,12209334,12209334,0,12209334,2017
3,20177,PFQ,PFQ,Asia Pacific,1,0,0,0,0,0,0,0,281235,281235,0,0,0,0,0,0,0,637370,637370,2017
3,20100,PO,PO,Polar Air Cargo Airways,3,3345667,710089,13841640,0,14551729,17897396,3345667,14551729,17897396,5396326,1407660,22374802,0,23782462,29178788,5396326,23782462,29178788,2017
3,19687,QX,QX,Horizon Air,2,0,0,0,0,0,0,0,0,0,0,0,0,0,0,0,0,0,0,2017
3,20422,SY,SY,Sun Country Airlines d/b/a MN Airlines,2,3383973,0,0,2474739,2474739,5858712,4271838,2509186,6781024,5846985,0,0,4600873,4600873,10447858,7986548,4672117,12658665,2017
3,20447,U7,U7,USA Jet Airlines Inc.,2,0,0,0,0,0,0,381138,5925,387063,0,0,0,0,0,0,648316,15464,663780,2017
3,19977,UA,UA,United Air Lines Inc.,3,130472224,52339060,58077680,32221932,142638672,273110896,131555230,143155980,274711210,204907031,83274717,96189441,54315559,233779717,438686748,207034297,234661094,441695391,2017
3,21171,VX,VX,Virgin America,3,15709447,0,0,182778,182778,15892225,15807018,182778,15989796,24268168,0,0,317056,317056,24585224,24430092,317056,24747148,2017
3,20195,WI,WI,Sky Lease Cargo,1,0,0,0,0,0,0,0,0,0,0,0,0,0,0,0,0,0,0,2017
3,20287,WP,WP,Island Air Hawaii,1,254069,0,0,0,0,254069,254069,0,254069,437911,0,0,0,0,437911,437911,0,437911,2017
3,20377,X9,X9,Omni Air International LLC,2,0,0,0,0,0,0,349441,2747464,3096905,0,0,0,0,0,0,596824,5501580,6098404,2017
3,20207,XP,XP,XTRA Airways,1,0,0,0,0,0,0,270546,337137,607683,0,0,0,0,0,0,538250,670732,1208982,2017
3,20378,YV,YV,Mesa Airlines Inc.,2,0,0,0,0,0,0,0,0,0,0,0,0,0,0,0,0,0,0,2017
3,20452,YX,YX,Republic Airline,2,0,0,0,0,0,0,0,0,0,0,0,0,0,0,0,0,0,0,2017
3,20046,ZW,ZW,Air Wisconsin Airlines Corp,2,3417,0,0,0,0,3417,3417,0,3417,11510,0,0,0,0,11510,11510,0,11510,2017
3,19393,WN,WN,Southwest Airlines Co.,3,176138446,0,0,1555790,1555790,177694236,176455638,1555790,178011428,316120814,0,0,3162162,3162162,319282976,316631120,3162162,319793282,2017
4,21161,09Q,09Q,"Swift Air, LLC",1,0,0,0,0,0,0,315422,123907,439329,0,0,0,0,0,0,930574,192449,1123023,2017
4,21352,0WQ,0WQ,Avjet Corporation,1,0,0,0,0,0,0,24181,0,24181,0,0,0,0,0,0,78587,0,78587,2017
4,21492,1BQ,1BQ,"Dynamic Airways, LLC",1,0,0,0,0,0,0,0,434772,434772,0,0,0,0,0,0,0,799372,799372,2017
4,21645,23Q,23Q,Songbird Airways Inc.,1,0,0,0,0,0,0,0,0,0,0,0,0,0,0,0,0,0,0,2017
4,21652,27Q,27Q,"Jet Aviation Flight Services, Inc.",1,0,0,0,0,0,0,0,0,0,0,0,0,0,0,0,0,0,0,2017
4,20408,5V,5V,Tatonduk Outfitters Limited d/b/a Everts Air Alaska and Everts Air Cargo,1,259552,0,0,0,0,259552,334666,0,334666,597109,0,0,0,0,597109,769912,0,769912,2017
4,19917,5X,5X,United Parcel Service,3,33287000,9707000,16669000,2871000,29247000,62534000,33287000,29247000,62534000,53185000,13537000,25397000,4899000,43833000,97018000,53185000,43833000,97018000,2017
4,20007,5Y,5Y,Atlas Air Inc.,3,0,0,0,0,0,0,7265951,25450828,32716779,0,0,0,0,0,0,13428495,45573048,59001543,2017
4,19874,8C,8C,Air Transport International,2,0,0,0,0,0,0,28212,569680,597892,0,0,0,0,0,0,64599,1072178,1136777,2017
4,20363,9E,9E,Endeavor Air Inc.,2,0,0,0,0,0,0,0,0,0,0,0,0,0,0,0,0,0,0,2017
4,20190,9S,9S,Southern Air Inc.,2,737333,4828121,549072,0,5377193,6114526,737333,5377193,6114526,1548399,10139054,1153051,0,11292105,12840504,1548399,11292105,12840504,2017
4,19805,AA,AA,American Airlines Inc.,3,174161962,46909341,23461409,48076804,118447554,292609516,174740655,118778726,293519381,270098352,73752975,36761868,81016615,191531458,461629810,270991067,192066802,463057869,2017
4,20453,ABX,ABX,ABX Air Inc,2,55914,0,0,0,0,55914,55914,0,55914,95853,0,0,0,0,95853,95853,0,95853,2017
4,19930,AS,AS,Alaska Airlines Inc.,3,40635486,0,0,710994,710994,41346480,40727280,710994,41438274,71841516,0,0,1293832,1293832,73135348,71986618,1293832,73280450,2017
4,20409,B6,B6,JetBlue Airways,3,54391710,0,0,12362959,12362959,66754669,54391710,12362959,66754669,90771586,0,0,20631919,20631919,111403505,90771586,20631919,111403505,2017
4,21167,CP,CP,Compass Airlines,2,0,0,0,0,0,0,0,0,0,0,0,0,0,0,0,0,0,0,2017
4,19790,DL,DL,Delta Air Lines Inc.,3,157911263,59231351,31888604,25496029,116615984,274527247,159491723,116662693,276154416,266830777,100086258,53883814,43081950,197052022,463882799,270564166,197130948,467695114,2017
4,21650,EE,EE,Eastern Airlines Group Inc.,1,0,0,0,0,0,0,63200,340400,403600,0,0,0,0,0,0,117552,633144,750696,2017
4,20366,EV,EV,ExpressJet Airlines Inc.,3,100179,0,0,0,0,100179,100179,0,100179,274593,0,0,0,0,274593,274593,0,274593,2017
4,20436,F9,F9,Frontier Airlines Inc.,3,17205721,0,0,1446486,1446486,18652207,17205721,1446486,18652207,26224109,0,0,2394867,2394867,28618976,26224109,2394867,28618976,2017
4,20107,FX,FX,Federal Express Corporation,3,57289512,12060464,20311371,1957823,34329658,91619170,58287307,35085417,93372724,89319000,19331000,32667000,3634000,55632000,144951000,90913000,57074000,147987000,2017
4,20368,G4,G4,Allegiant Air,3,15116517,0,0,0,0,15116517,15957439,0,15957439,27004194,0,0,0,0,27004194,28584598,0,28584598,2017
4,20500,G7,G7,GoJet Airlines LLC d/b/a United Express,2,0,0,0,0,0,0,0,0,0,0,0,0,0,0,0,0,0,0,2017
4,20166,GFQ,GFQ,Gulf And Caribbean Cargo,1,0,0,0,0,0,0,119572,84553,204125,0,0,0,0,0,0,240225,187288,427513,2017
4,20402,GL,GL,Miami Air International,2,0,0,0,0,0,0,358934,269091,628025,0,0,0,0,0,0,815200,611151,1426351,2017
4,19690,HA,HA,Hawaiian Airlines Inc.,3,13662772,0,6930218,0,6930218,20592990,13662772,6930218,20592990,21684775,0,10926761,0,10926761,32611536,21684775,10926761,32611536,2017
4,20310,WL,K8,"Caribbean Sun Airlines, Inc. d/b/a World Atlantic Airlines",1,0,0,0,0,0,0,6433,208835,215268,0,0,0,0,0,0,821,26644,27465,2017
4,20370,KAQ,KAQ,Kalitta Air LLC,2,0,0,0,0,0,0,788861,3414450,4203311,0,0,0,0,0,0,1304710,6596782,7901492,2017
4,21629,KD,KD,Western Global,1,0,0,0,0,0,0,341497,647006,988503,0,0,0,0,0,0,720206,1374015,2094221,2017
4,21634,KH,KH,Aloha Air Cargo,1,427115,0,0,0,0,427115,427115,0,427115,686737,0,0,0,0,686737,686737,0,686737,2017
4,20372,KLQ,KLQ,Kalitta Charters II,1,0,0,0,0,0,0,79461,16457,95918,0,0,0,0,0,0,181097,38233,219330,2017
4,20169,L2,L2,Lynden Air Cargo Airlines,1,82738,0,0,0,0,82738,141851,17104,158955,168148,0,0,0,0,168148,281504,38735,320239,2017
4,20151,M6,M6,Amerijet International,2,0,0,0,1381608,1381608,1381608,206657,1413369,1620026,0,0,0,2428541,2428541,2428541,363254,2484369,2847623,2017
4,20398,MQ,MQ,Envoy Air,3,0,0,0,0,0,0,0,0,0,0,0,0,0,0,0,0,0,0,2017
4,20405,N8,N8,National Air Cargo Group Inc d/ba National Airlines,1,0,0,0,0,0,0,199156,927986,1127142,0,0,0,0,0,0,497064,1730240,2227304,2017
4,20108,NC,NC,Northern Air Cargo Inc.,1,325648,0,0,0,0,325648,395668,3042,398710,579495,0,0,0,0,579495,702806,5379,708185,2017
4,20416,NK,NK,Spirit Air Lines,3,25480486,0,0,2245832,2245832,27726318,25480486,2245832,27726318,44252004,0,0,3900340,3900340,48152344,44252004,3900340,48152344,2017
4,20397,OH,OH,PSA Airlines Inc.,2,0,0,0,0,0,0,0,0,0,0,0,0,0,0,0,0,0,0,2017
4,20304,OO,OO,SkyWest Airlines Inc.,3,6298173,0,0,0,0,6298173,6298173,0,6298173,12295026,0,0,0,0,12295026,12295026,0,12295026,2017
4,20177,PFQ,PFQ,Asia Pacific,1,0,0,0,0,0,0,0,260657,260657,0,0,0,0,0,0,0,497855,497855,2017
4,20100,PO,PO,Polar Air Cargo Airways,3,3392925,750949,12697597,0,13448546,16841471,3392925,13448546,16841471,5204366,1488804,19863036,0,21351840,26556206,5204366,21351840,26556206,2017
4,19687,QX,QX,Horizon Air,2,0,0,0,0,0,0,0,0,0,0,0,0,0,0,0,0,0,0,2017
4,20422,SY,SY,Sun Country Airlines d/b/a MN Airlines,2,3391773,0,0,1421105,1421105,4812878,3840520,1491746,5332266,5945822,0,0,2644005,2644005,8589827,7445467,2786393,10231860,2017
4,20447,U7,U7,USA Jet Airlines Inc.,2,0,0,0,0,0,0,316858,17534,334392,0,0,0,0,0,0,535490,42608,578098,2017
4,19977,UA,UA,United Air Lines Inc.,3,124867409,56916057,55176703,30636825,142729585,267596994,125813183,143433872,269247055,196070774,89462490,88774919,50986098,229223507,425294281,197799156,230389767,428188923,2017
4,21171,VX,VX,Virgin America,3,15666194,0,0,206840,206840,15873034,15752532,206840,15959372,24660573,0,0,365581,365581,25026154,24813227,365581,25178808,2017
4,20195,WI,WI,Sky Lease Cargo,1,0,0,0,0,0,0,0,0,0,0,0,0,0,0,0,0,0,0,2017
4,20287,WP,WP,Island Air Hawaii,1,264308,0,0,0,0,264308,264308,0,264308,436117,0,0,0,0,436117,436117,0,436117,2017
4,20377,X9,X9,Omni Air International LLC,2,0,0,0,0,0,0,325043,2794622,3119665,0,0,0,0,0,0,586636,5142894,5729530,2017
4,20207,XP,XP,XTRA Airways,1,0,0,0,0,0,0,88573,335675,424248,0,0,0,0,0,0,176216,667824,844040,2017
4,20378,YV,YV,Mesa Airlines Inc.,2,0,0,0,0,0,0,0,0,0,0,0,0,0,0,0,0,0,0,2017
4,20452,YX,YX,Republic Airline,2,0,0,0,0,0,0,0,0,0,0,0,0,0,0,0,0,0,0,2017
4,20046,ZW,ZW,Air Wisconsin Airlines Corp,2,6569,0,0,0,0,6569,6569,0,6569,21186,0,0,0,0,21186,21186,0,21186,2017
4,19393,WN,WN,Southwest Airlines Co.,3,174221984,0,0,1848321,1848321,176070305,174800743,1860876,176661619,315492439,0,0,3697789,3697789,319190228,316399169,3723599,320122768,2017
5,21161,09Q,09Q,"Swift Air, LLC",1,0,0,0,0,0,0,264982,80122,345104,0,0,0,0,0,0,707943,179910,887853,2017
5,21352,0WQ,0WQ,Avjet Corporation,1,0,0,0,0,0,0,20236,0,20236,0,0,0,0,0,0,63541,0,63541,2017
5,21492,1BQ,1BQ,"Dynamic Airways, LLC",1,0,0,0,0,0,0,221152,186732,407884,0,0,0,0,0,0,350330,538432,888762,2017
5,21645,23Q,23Q,Songbird Airways Inc.,1,0,0,0,0,0,0,0,0,0,0,0,0,0,0,0,0,0,0,2017
5,21652,27Q,27Q,"Jet Aviation Flight Services, Inc.",1,0,0,0,0,0,0,0,0,0,0,0,0,0,0,0,0,0,0,2017
5,20408,5V,5V,Tatonduk Outfitters Limited d/b/a Everts Air Alaska and Everts Air Cargo,1,285133,0,0,0,0,285133,432867,0,432867,619895,0,0,0,0,619895,941077,0,941077,2017
5,19917,5X,5X,United Parcel Service,3,36986000,10132000,17644000,3312000,31088000,68074000,36986000,31088000,68074000,55306000,13615000,26955000,5399000,45969000,101275000,55306000,45969000,101275000,2017
5,20007,5Y,5Y,Atlas Air Inc.,3,0,0,0,0,0,0,8327603,28276453,36604056,0,0,0,0,0,0,14288848,50876967,65165815,2017
5,19874,8C,8C,Air Transport International,2,0,0,0,0,0,0,29957,597288,627245,0,0,0,0,0,0,68983,1134550,1203533,2017
5,20363,9E,9E,Endeavor Air Inc.,2,0,0,0,0,0,0,0,0,0,0,0,0,0,0,0,0,0,0,2017
5,20190,9S,9S,Southern Air Inc.,2,782631,4847714,586625,0,5434339,6216970,782631,5434339,6216970,1643525,10180199,1231913,0,11412112,13055637,1643525,11412112,13055637,2017
5,19805,AA,AA,American Airlines Inc.,3,184344005,60103953,24718134,46807612,131629699,315973704,184950607,131910438,316861045,274554725,92440148,38103168,77008964,207552280,482107005,275459168,208013455,483472623,2017
5,20453,ABX,ABX,ABX Air Inc,2,29271,0,0,0,0,29271,29271,0,29271,48005,0,0,0,0,48005,48005,0,48005,2017
5,19930,AS,AS,Alaska Airlines Inc.,3,41937641,0,0,457027,457027,42394668,42011843,457027,42468870,70348904,0,0,805754,805754,71154658,70461951,805754,71267705,2017
5,20409,B6,B6,JetBlue Airways,3,54864422,0,0,11918275,11918275,66782697,54864422,11918275,66782697,88155076,0,0,19150050,19150050,107305126,88155076,19150050,107305126,2017
5,21167,CP,CP,Compass Airlines,2,0,0,0,0,0,0,0,0,0,0,0,0,0,0,0,0,0,0,2017
5,19790,DL,DL,Delta Air Lines Inc.,3,171734962,67698738,33197021,24127550,125023309,296758271,172868906,125120027,297988933,290969513,114701564,56245512,40879163,211826239,502795752,293977963,211990108,505968071,2017
5,21650,EE,EE,Eastern Airlines Group Inc.,1,0,0,0,0,0,0,33040,206880,239920,0,0,0,0,0,0,57490,359971,417461,2017
5,20366,EV,EV,ExpressJet Airlines Inc.,3,104685,0,0,0,0,104685,104685,0,104685,264323,0,0,0,0,264323,264323,0,264323,2017
5,20436,F9,F9,Frontier Airlines Inc.,3,18893480,0,0,1218777,1218777,20112257,18893480,1218777,20112257,27255359,0,0,1949749,1949749,29205108,27255359,1949749,29205108,2017
5,20107,FX,FX,Federal Express Corporation,3,57521672,12804952,21235518,2177197,36217667,93739339,58766605,37226678,95993283,84051000,19659000,34032000,3785000,57476000,141527000,85946421,59364000,145310421,2017
5,20368,G4,G4,Allegiant Air,3,14611657,0,0,0,0,14611657,15460025,0,15460025,24669683,0,0,0,0,24669683,26166845,0,26166845,2017
5,20500,G7,G7,GoJet Airlines LLC d/b/a United Express,2,0,0,0,0,0,0,0,0,0,0,0,0,0,0,0,0,0,0,2017
5,20166,GFQ,GFQ,Gulf And Caribbean Cargo,1,0,0,0,0,0,0,204384,224104,428488,0,0,0,0,0,0,395106,449951,845057,2017
5,20402,GL,GL,Miami Air International,2,0,0,0,0,0,0,237296,231067,468363,0,0,0,0,0,0,511850,498413,1010263,2017
5,19690,HA,HA,Hawaiian Airlines Inc.,3,14425410,0,7151420,0,7151420,21576830,14425410,7151420,21576830,21727441,0,11113976,0,11113976,32841417,21727441,11113976,32841417,2017
5,20310,WL,K8,"Caribbean Sun Airlines, Inc. d/b/a World Atlantic Airlines",1,0,0,0,0,0,0,3104,232254,235358,0,0,0,0,0,0,586,43836,44422,2017
5,20370,KAQ,KAQ,Kalitta Air LLC,2,0,0,0,0,0,0,830460,3514855,4345315,0,0,0,0,0,0,1290753,6465150,7755903,2017
5,21629,KD,KD,Western Global,1,0,0,0,0,0,0,777025,1960007,2737032,0,0,0,0,0,0,1681942,3630975,5312917,2017
5,21634,KH,KH,Aloha Air Cargo,1,446198,0,0,0,0,446198,446198,0,446198,685578,0,0,0,0,685578,685578,0,685578,2017
5,20372,KLQ,KLQ,Kalitta Charters II,1,0,0,0,0,0,0,177695,87619,265314,0,0,0,0,0,0,381694,184785,566479,2017
5,20169,L2,L2,Lynden Air Cargo Airlines,1,83416,0,0,0,0,83416,167770,0,167770,156468,0,0,0,0,156468,348398,0,348398,2017
5,20151,M6,M6,Amerijet International,2,0,0,0,1449821,1449821,1449821,273866,1552642,1826508,0,0,0,2478182,2478182,2478182,468120,2653934,3122054,2017
5,20398,MQ,MQ,Envoy Air,3,0,0,0,0,0,0,0,0,0,0,0,0,0,0,0,0,0,0,2017
5,20405,N8,N8,National Air Cargo Group Inc d/ba National Airlines,1,0,0,0,0,0,0,102838,1193673,1296511,0,0,0,0,0,0,218715,2326982,2545697,2017
5,20108,NC,NC,Northern Air Cargo Inc.,1,364157,0,0,0,0,364157,398594,0,398594,618963,0,0,0,0,618963,672293,0,672293,2017
5,20416,NK,NK,Spirit Air Lines,3,25642228,0,0,2598111,2598111,28240339,25642228,2598111,28240339,41968961,0,0,4252362,4252362,46221323,41968961,4252362,46221323,2017
5,20397,OH,OH,PSA Airlines Inc.,2,0,0,0,0,0,0,0,0,0,0,0,0,0,0,0,0,0,0,2017
5,20304,OO,OO,SkyWest Airlines Inc.,3,6492944,0,0,0,0,6492944,6492944,0,6492944,12279100,0,0,0,0,12279100,12279100,0,12279100,2017
5,20177,PFQ,PFQ,Asia Pacific,1,0,0,0,0,0,0,0,286157,286157,0,0,0,0,0,0,0,545208,545208,2017
5,20100,PO,PO,Polar Air Cargo Airways,3,3003912,731703,12165638,0,12897341,15901253,3003912,12897341,15901253,4657122,1420842,19235648,0,20656490,25313612,4657122,20656490,25313612,2017
5,19687,QX,QX,Horizon Air,2,0,0,0,0,0,0,0,0,0,0,0,0,0,0,0,0,0,0,2017
5,20422,SY,SY,Sun Country Airlines d/b/a MN Airlines,2,3217517,0,0,311449,311449,3528966,3715351,413131,4128482,5211491,0,0,556963,556963,5768454,7012131,751865,7763996,2017
5,20447,U7,U7,USA Jet Airlines Inc.,2,0,0,0,0,0,0,562261,19207,581468,0,0,0,0,0,0,905240,46673,951913,2017
5,19977,UA,UA,United Air Lines Inc.,3,136194766,70244425,57401517,26219983,153865925,290060691,136992444,154609903,291602347,204100824,107288108,91566841,42304198,241159147,445259971,205921730,242394024,448315754,2017
5,21171,VX,VX,Virgin America,3,16913372,0,0,188379,188379,17101751,17037849,188379,17226228,24808526,0,0,315566,315566,25124092,25009576,315566,25325142,2017
5,20195,WI,WI,Sky Lease Cargo,1,0,0,0,0,0,0,1959,1655975,1657934,0,0,0,0,0,0,3549,2859161,2862710,2017
5,20287,WP,WP,Island Air Hawaii,1,246723,0,0,0,0,246723,246723,0,246723,402073,0,0,0,0,402073,402073,0,402073,2017
5,20377,X9,X9,Omni Air International LLC,2,0,0,0,0,0,0,493558,2279273,2772831,0,0,0,0,0,0,879568,4267226,5146794,2017
5,20207,XP,XP,XTRA Airways,1,0,0,0,0,0,0,116089,313089,429178,0,0,0,0,0,0,230959,622889,853848,2017
5,20378,YV,YV,Mesa Airlines Inc.,2,0,0,0,0,0,0,0,0,0,0,0,0,0,0,0,0,0,0,2017
5,20452,YX,YX,Republic Airline,2,0,0,0,0,0,0,0,0,0,0,0,0,0,0,0,0,0,0,2017
5,20046,ZW,ZW,Air Wisconsin Airlines Corp,2,9096,0,0,0,0,9096,9096,0,9096,29646,0,0,0,0,29646,29646,0,29646,2017
5,19393,WN,WN,Southwest Airlines Co.,3,174763355,0,0,1762055,1762055,176525410,175047875,1762055,176809930,310012696,0,0,3271079,3271079,313283775,310447072,3271079,313718151,2017
6,21161,09Q,09Q,"Swift Air, LLC",1,0,0,0,0,0,0,343701,63800,407501,0,0,0,0,0,0,596442,71991,668433,2017
6,21352,0WQ,0WQ,Avjet Corporation,1,0,0,0,0,0,0,21206,0,21206,0,0,0,0,0,0,62770,0,62770,2017
6,21492,1BQ,1BQ,"Dynamic Airways, LLC",1,0,0,0,0,0,0,8397,644723,653120,0,0,0,0,0,0,26793,1084096,1110889,2017
6,21645,23Q,23Q,Songbird Airways Inc.,1,0,0,0,0,0,0,0,0,0,0,0,0,0,0,0,0,0,0,2017
6,21652,27Q,27Q,"Jet Aviation Flight Services, Inc.",1,0,0,0,0,0,0,0,0,0,0,0,0,0,0,0,0,0,0,2017
6,20408,5V,5V,Tatonduk Outfitters Limited d/b/a Everts Air Alaska and Everts Air Cargo,1,344358,0,0,0,0,344358,503565,0,503565,779648,0,0,0,0,779648,1140102,0,1140102,2017
6,19917,5X,5X,United Parcel Service,3,37234000,10366000,18484000,2936000,31786000,69020000,37234000,31786000,69020000,53471000,13650000,27037000,4599000,45286000,98757000,53471000,45286000,98757000,2017
6,20007,5Y,5Y,Atlas Air Inc.,3,0,0,0,0,0,0,8617482,27525044,36142526,0,0,0,0,0,0,15200722,49390765,64591487,2017
6,19874,8C,8C,Air Transport International,2,0,0,0,0,0,0,20189,596820,617009,0,0,0,0,0,0,42153,1160498,1202651,2017
6,20363,9E,9E,Endeavor Air Inc.,2,0,0,0,0,0,0,0,0,0,0,0,0,0,0,0,0,0,0,2017
6,20190,9S,9S,Southern Air Inc.,2,792960,5129018,640107,0,5769125,6562085,792960,5769125,6562085,1665216,10770938,1344225,0,12115163,13780379,1665216,12115163,13780379,2017
6,19805,AA,AA,American Airlines Inc.,3,190147694,60591000,24157072,48077146,132825218,322972912,190611989,133099149,323711138,266443561,88633637,35343485,76019224,199996346,466439907,267101917,200427146,467529063,2017
6,20453,ABX,ABX,ABX Air Inc,2,93272,0,0,0,0,93272,93272,0,93272,143639,0,0,0,0,143639,143639,0,143639,2017
6,19930,AS,AS,Alaska Airlines Inc.,3,42914702,0,0,473564,473564,43388266,43054527,473564,43528091,70103670,0,0,806578,806578,70910248,70305517,806578,71112095,2017
6,20409,B6,B6,JetBlue Airways,3,55411950,0,0,12925472,12925472,68337422,55411950,12925472,68337422,86224125,0,0,20112765,20112765,106336890,86224125,20112765,106336890,2017
6,21167,CP,CP,Compass Airlines,2,0,0,0,0,0,0,0,0,0,0,0,0,0,0,0,0,0,0,2017
6,19790,DL,DL,Delta Air Lines Inc.,3,181068554,79621892,35331060,24145873,139098825,320167379,182177909,139135939,321313848,296091667,130201397,57774983,39484448,227460828,523552495,298982922,227521518,526504440,2017
6,21650,EE,EE,Eastern Airlines Group Inc.,1,0,0,0,0,0,0,3200,246560,249760,0,0,0,0,0,0,5376,414221,419597,2017
6,20366,EV,EV,ExpressJet Airlines Inc.,3,14037,0,0,0,0,14037,14037,0,14037,80785,0,0,0,0,80785,80785,0,80785,2017
6,20436,F9,F9,Frontier Airlines Inc.,3,19568585,0,0,1154936,1154936,20723521,19568585,1154936,20723521,26852011,0,0,1781286,1781286,28633297,26852011,1781286,28633297,2017
6,20107,FX,FX,Federal Express Corporation,3,59083727,12501195,21176572,2149501,35827268,94910995,60279995,36439280,96719275,82754000,18532000,32631000,3612000,54775000,137529000,84463000,55886000,140349000,2017
6,20368,G4,G4,Allegiant Air,3,17387508,0,0,0,0,17387508,18440370,0,18440370,28429215,0,0,0,0,28429215,30242275,0,30242275,2017
6,20500,G7,G7,GoJet Airlines LLC d/b/a United Express,2,0,0,0,0,0,0,0,0,0,0,0,0,0,0,0,0,0,0,2017
6,20166,GFQ,GFQ,Gulf And Caribbean Cargo,1,0,0,0,0,0,0,212857,290573,503430,0,0,0,0,0,0,380258,547223,927481,2017
6,20402,GL,GL,Miami Air International,2,0,0,0,0,0,0,292920,165065,457985,0,0,0,0,0,0,661021,372495,1033516,2017
6,19690,HA,HA,Hawaiian Airlines Inc.,3,15300516,0,7036145,0,7036145,22336661,15300516,7036145,22336661,22502209,0,10567691,0,10567691,33069900,22502209,10567691,33069900,2017
6,20370,KAQ,KAQ,Kalitta Air LLC,2,0,0,0,0,0,0,407415,3585500,3992915,0,0,0,0,0,0,672897,6519148,7192045,2017
6,21634,KH,KH,Aloha Air Cargo,1,435471,0,0,0,0,435471,435471,0,435471,650255,0,0,0,0,650255,650255,0,650255,2017
6,20372,KLQ,KLQ,Kalitta Charters II,1,0,0,0,0,0,0,183748,125536,309284,0,0,0,0,0,0,404953,269282,674235,2017
6,20169,L2,L2,Lynden Air Cargo Airlines,1,87506,0,0,0,0,87506,245288,65993,311281,175421,0,0,0,0,175421,508406,144126,652532,2017
6,20151,M6,M6,Amerijet International,2,0,0,0,1546686,1546686,1546686,274254,1785686,2059940,0,0,0,2635138,2635138,2635138,467255,3042330,3509585,2017
6,20398,MQ,MQ,Envoy Air,3,0,0,0,0,0,0,0,0,0,0,0,0,0,0,0,0,0,0,2017
6,20405,N8,N8,National Air Cargo Group Inc d/ba National Airlines,1,0,0,0,0,0,0,207401,628964,836365,0,0,0,0,0,0,548121,1213985,1762106,2017
6,20108,NC,NC,Northern Air Cargo Inc.,1,414221,0,0,0,0,414221,562388,0,562388,735897,0,0,0,0,735897,955645,0,955645,2017
6,20416,NK,NK,Spirit Air Lines,3,29420506,0,0,1321924,1321924,30742430,29420506,1321924,30742430,45859708,0,0,2060572,2060572,47920280,45859708,2060572,47920280,2017
6,20397,OH,OH,PSA Airlines Inc.,2,0,0,0,0,0,0,0,0,0,0,0,0,0,0,0,0,0,0,2017
6,20304,OO,OO,SkyWest Airlines Inc.,3,6696044,0,0,0,0,6696044,6696044,0,6696044,11958643,0,0,0,0,11958643,11958643,0,11958643,2017
6,20177,PFQ,PFQ,Asia Pacific,1,0,0,0,0,0,0,0,271285,271285,0,0,0,0,0,0,0,511364,511364,2017
6,20100,PO,PO,Polar Air Cargo Airways,3,3304234,732588,13110111,0,13842699,17146933,3304234,13842699,17146933,4895835,1384152,20032325,0,21416477,26312312,4895835,21416477,26312312,2017
6,19687,QX,QX,Horizon Air,2,0,0,0,0,0,0,0,0,0,0,0,0,0,0,0,0,0,0,2017
6,20422,SY,SY,Sun Country Airlines d/b/a MN Airlines,2,3566553,0,0,611086,611086,4177639,4207451,637592,4845043,5589898,0,0,1059560,1059560,6649458,7437040,1110412,8547452,2017
6,20447,U7,U7,USA Jet Airlines Inc.,2,0,0,0,0,0,0,641654,49382,691036,0,0,0,0,0,0,988147,134541,1122688,2017
6,19977,UA,UA,United Air Lines Inc.,3,147002367,73206279,55316801,29785435,158308515,305310882,147787575,158576625,306364200,211562276,107921357,84806015,45987260,238714632,450276908,213166688,239131969,452298657,2017
6,21171,VX,VX,Virgin America,3,17585740,0,0,211983,211983,17797723,17705692,211983,17917675,24755095,0,0,338926,338926,25094021,24936051,338926,25274977,2017
6,20195,WI,WI,Sky Lease Cargo,1,0,0,0,0,0,0,0,1689270,1689270,0,0,0,0,0,0,0,2882444,2882444,2017
6,20287,WP,WP,Island Air Hawaii,1,352203,0,0,0,0,352203,352203,0,352203,560715,0,0,0,0,560715,560715,0,560715,2017
6,20377,X9,X9,Omni Air International LLC,2,0,0,0,0,0,0,727326,2429766,3157092,0,0,0,0,0,0,1523815,4822286,6346101,2017
6,20207,XP,XP,XTRA Airways,1,0,0,0,0,0,0,49032,210679,259711,0,0,0,0,0,0,97549,419145,516694,2017
6,20378,YV,YV,Mesa Airlines Inc.,2,0,0,0,0,0,0,0,0,0,0,0,0,0,0,0,0,0,0,2017
6,20452,YX,YX,Republic Airline,2,0,0,0,0,0,0,0,0,0,0,0,0,0,0,0,0,0,0,2017
6,20046,ZW,ZW,Air Wisconsin Airlines Corp,2,5082,0,0,0,0,5082,5082,0,5082,15632,0,0,0,0,15632,15632,0,15632,2017
6,19393,WN,WN,Southwest Airlines Co.,3,180432110,0,0,2186663,2186663,182618773,180817409,2186663,183004072,304383184,0,0,3991732,3991732,308374916,304998125,3991732,308989857,2017
7,21161,09Q,09Q,"Swift Air, LLC",1,0,0,0,0,0,0,269928,92071,361999,0,0,0,0,0,0,710238,131412,841650,2017
7,21352,0WQ,0WQ,Avjet Corporation,1,0,0,0,0,0,0,26331,0,26331,0,0,0,0,0,0,78467,0,78467,2017
7,21492,1BQ,1BQ,"Dynamic Airways, LLC",1,0,0,0,0,0,0,375473,254772,630245,0,0,0,0,0,0,571635,483566,1055201,2017
7,21645,23Q,23Q,Songbird Airways Inc.,1,0,0,0,0,0,0,0,0,0,0,0,0,0,0,0,0,0,0,2017
7,21652,27Q,27Q,"Jet Aviation Flight Services, Inc.",1,0,0,0,0,0,0,0,0,0,0,0,0,0,0,0,0,0,0,2017
7,20408,5V,5V,Tatonduk Outfitters Limited d/b/a Everts Air Alaska and Everts Air Cargo,1,372598,0,0,0,0,372598,503327,0,503327,768765,0,0,0,0,768765,1038493,0,1038493,2017
7,19917,5X,5X,United Parcel Service,3,35444000,10578000,18313000,2908000,31799000,67243000,35444000,31799000,67243000,52018000,13840000,25840000,4599000,44279000,96297000,52018000,44279000,96297000,2017
7,20007,5Y,5Y,Atlas Air Inc.,3,0,0,0,0,0,0,9165574,29292672,38458246,0,0,0,0,0,0,14404333,49163008,63567341,2017
7,19874,8C,8C,Air Transport International,2,0,0,0,0,0,0,23508,599642,623150,0,0,0,0,0,0,37925,1161279,1199204,2017
7,20363,9E,9E,Endeavor Air Inc.,2,0,0,0,0,0,0,0,0,0,0,0,0,0,0,0,0,0,0,2017
7,20190,9S,9S,Southern Air Inc.,2,716129,5389214,604086,0,5993300,6709429,716129,5993300,6709429,1503871,11317349,1268581,0,12585930,14089801,1503871,12585930,14089801,2017
7,19805,AA,AA,American Airlines Inc.,3,197554459,63445849,25337712,51281946,140065507,337619966,198270086,140175142,338445228,280616472,93217466,36783896,80680460,210681822,491298294,281636177,210845341,492481518,2017
7,20453,ABX,ABX,ABX Air Inc,2,35785,0,0,0,0,35785,35785,0,35785,64195,0,0,0,0,64195,64195,0,64195,2017
7,19930,AS,AS,Alaska Airlines Inc.,3,44610986,0,0,434443,434443,45045429,44702939,434443,45137382,73981628,0,0,763263,763263,74744891,74117433,763263,74880696,2017
7,20409,B6,B6,JetBlue Airways,3,58409734,0,0,15288778,15288778,73698512,58409734,15288778,73698512,91168434,0,0,23863384,23863384,115031818,91168434,23863384,115031818,2017
7,21167,CP,CP,Compass Airlines,2,0,0,0,0,0,0,0,0,0,0,0,0,0,0,0,0,0,0,2017
7,19790,DL,DL,Delta Air Lines Inc.,3,189998529,82186255,37233627,25516913,144936795,334935324,191063533,144949549,336013082,315405002,136432402,61809279,42359075,240600756,556005758,318321781,240621928,558943709,2017
7,21650,EE,EE,Eastern Airlines Group Inc.,1,0,0,0,0,0,0,1920,278560,280480,0,0,0,0,0,0,3206,465195,468401,2017
7,20366,EV,EV,ExpressJet Airlines Inc.,3,108679,0,0,0,0,108679,108679,0,108679,75814,0,0,0,0,75814,75814,0,75814,2017
7,20436,F9,F9,Frontier Airlines Inc.,3,20736474,0,0,1556365,1556365,22292839,20736474,1556365,22292839,28849738,0,0,2339991,2339991,31189729,28849738,2339991,31189729,2017
7,20107,FX,FX,Federal Express Corporation,3,54052622,13449128,21709741,1991984,37150853,91203475,55252278,37513984,92766262,77676000,19972000,32487000,3334000,55793000,133469000,79483000,56415000,135898000,2017
7,20368,G4,G4,Allegiant Air,3,18033317,0,0,0,0,18033317,18881989,0,18881989,30072036,0,0,0,0,30072036,31523539,0,31523539,2017
7,20500,G7,G7,GoJet Airlines LLC d/b/a United Express,2,0,0,0,0,0,0,0,0,0,0,0,0,0,0,0,0,0,0,2017
7,20166,GFQ,GFQ,Gulf And Caribbean Cargo,1,0,0,0,0,0,0,170384,163508,333892,0,0,0,0,0,0,348869,380634,729503,2017
7,20402,GL,GL,Miami Air International,2,0,0,0,0,0,0,202112,203111,405223,0,0,0,0,0,0,460260,462535,922795,2017
7,19690,HA,HA,Hawaiian Airlines Inc.,3,15648967,0,7226973,0,7226973,22875940,15648967,7226973,22875940,23256887,0,10520827,0,10520827,33777714,23256887,10520827,33777714,2017
7,20370,KAQ,KAQ,Kalitta Air LLC,2,0,0,0,0,0,0,1359305,4313712,5673017,0,0,0,0,0,0,2165703,7664561,9830264,2017
7,21629,KD,KD,Western Global,1,0,0,0,0,0,0,941625,1052083,1993708,0,0,0,0,0,0,2222268,2205246,4427514,2017
7,21634,KH,KH,Aloha Air Cargo,1,414024,0,0,0,0,414024,414024,0,414024,614620,0,0,0,0,614620,614620,0,614620,2017
7,20372,KLQ,KLQ,Kalitta Charters II,1,0,0,0,0,0,0,75005,39334,114339,0,0,0,0,0,0,158711,87944,246655,2017
7,20169,L2,L2,Lynden Air Cargo Airlines,1,92350,0,0,0,0,92350,315006,0,315006,206492,0,0,0,0,206492,648926,0,648926,2017
7,20151,M6,M6,Amerijet International,2,0,0,0,1490067,1490067,1490067,246657,1585022,1831679,0,0,0,2442694,2442694,2442694,404349,2598355,3002704,2017
7,20398,MQ,MQ,Envoy Air,3,0,0,0,0,0,0,0,0,0,0,0,0,0,0,0,0,0,0,2017
7,20405,N8,N8,National Air Cargo Group Inc d/ba National Airlines,1,0,0,0,0,0,0,174020,353253,527273,0,0,0,0,0,0,444253,647059,1091312,2017
7,20108,NC,NC,Northern Air Cargo Inc.,1,414504,0,0,0,0,414504,567281,0,567281,714746,0,0,0,0,714746,951386,0,951386,2017
7,20416,NK,NK,Spirit Air Lines,3,29370164,0,0,2623479,2623479,31993643,29370164,2623479,31993643,46524442,0,0,4155778,4155778,50680220,46524442,4155778,50680220,2017
7,20397,OH,OH,PSA Airlines Inc.,2,0,0,0,0,0,0,0,0,0,0,0,0,0,0,0,0,0,0,2017
7,20304,OO,OO,SkyWest Airlines Inc.,3,6863914,0,0,0,0,6863914,6863914,0,6863914,12687143,0,0,0,0,12687143,12687143,0,12687143,2017
7,20177,PFQ,PFQ,Asia Pacific,1,0,0,0,0,0,0,0,303964,303964,0,0,0,0,0,0,0,546956,546956,2017
7,20100,PO,PO,Polar Air Cargo Airways,3,3109539,813350,12848534,0,13661884,16771423,3109539,13661884,16771423,4676362,1556684,19346618,0,20903302,25579664,4676362,20903302,25579664,2017
7,19687,QX,QX,Horizon Air,2,0,0,0,0,0,0,0,0,0,0,0,0,0,0,0,0,0,0,2017
7,20422,SY,SY,Sun Country Airlines d/b/a MN Airlines,2,4163354,0,0,691469,691469,4854823,4623556,739918,5363474,6691551,0,0,1226364,1226364,7917915,8213389,1319591,9532980,2017
7,20447,U7,U7,USA Jet Airlines Inc.,2,0,0,0,0,0,0,455983,31689,487672,0,0,0,0,0,0,706774,72568,779342,2017
7,19977,UA,UA,United Air Lines Inc.,3,152990961,76421774,57293387,33675843,167391004,320381965,153765967,167657495,321423462,221388976,111262220,85479850,51133865,247875935,469264911,222524850,248310823,470835673,2017
7,21171,VX,VX,Virgin America,3,18301668,0,0,240124,240124,18541792,18301668,240124,18541792,27028971,0,0,392914,392914,27421885,27028971,392914,27421885,2017
7,20195,WI,WI,Sky Lease Cargo,1,0,0,0,0,0,0,0,1447168,1447168,0,0,0,0,0,0,0,2450131,2450131,2017
7,20310,WL,WL,"Caribbean Sun Airlines, Inc. d/b/a World Atlantic Airlines",1,0,0,0,0,0,0,10821,301463,312284,0,0,0,0,0,0,8177,227793,235970,2017
7,20287,WP,WP,Island Air Hawaii,1,418321,0,0,0,0,418321,418321,0,418321,656047,0,0,0,0,656047,656047,0,656047,2017
7,20377,X9,X9,Omni Air International LLC,2,0,0,0,0,0,0,496268,3130958,3627226,0,0,0,0,0,0,1056958,5895055,6952013,2017
7,20207,XP,XP,XTRA Airways,1,0,0,0,0,0,0,114034,512659,626693,0,0,0,0,0,0,226870,1019933,1246803,2017
7,20378,YV,YV,Mesa Airlines Inc.,2,0,0,0,0,0,0,0,0,0,0,0,0,0,0,0,0,0,0,2017
7,20452,YX,YX,Republic Airline,2,0,0,0,0,0,0,0,0,0,0,0,0,0,0,0,0,0,0,2017
7,20046,ZW,ZW,Air Wisconsin Airlines Corp,2,7268,0,0,0,0,7268,7268,0,7268,22107,0,0,0,0,22107,22107,0,22107,2017
7,19393,WN,WN,Southwest Airlines Co.,3,185619040,0,0,3054041,3054041,188673081,185951899,3054041,189005940,314227028,0,0,5384268,5384268,319611296,314713847,5384268,320098115,2017
8,21161,09Q,09Q,"Swift Air, LLC",1,0,0,0,0,0,0,250019,139987,390006,0,0,0,0,0,0,706936,255172,962108,2017
8,21352,0WQ,0WQ,Avjet Corporation,1,0,0,0,0,0,0,24795,1701,26496,0,0,0,0,0,0,78602,4645,83247,2017
8,21645,23Q,23Q,Songbird Airways Inc.,1,0,0,0,0,0,0,0,0,0,0,0,0,0,0,0,0,0,0,2017
8,21652,27Q,27Q,"Jet Aviation Flight Services, Inc.",1,0,0,0,0,0,0,0,0,0,0,0,0,0,0,0,0,0,0,2017
8,20408,5V,5V,Tatonduk Outfitters Limited d/b/a Everts Air Alaska and Everts Air Cargo,1,407416,0,0,0,0,407416,511710,0,511710,926118,0,0,0,0,926118,1163194,0,1163194,2017
8,19917,5X,5X,United Parcel Service,3,39817000,11059000,18575000,3122000,32756000,72573000,39817000,32756000,72573000,64138000,17894000,29071000,5415000,52380000,116518000,64138000,52380000,116518000,2017
8,20007,5Y,5Y,Atlas Air Inc.,3,0,0,0,0,0,0,9409304,28734700,38144004,0,0,0,0,0,0,16600216,50566583,67166799,2017
8,19874,8C,8C,Air Transport International,2,0,0,0,0,0,0,74274,612456,686730,0,0,0,0,0,0,111786,1124358,1236144,2017
8,20363,9E,9E,Endeavor Air Inc.,2,0,0,0,0,0,0,0,0,0,0,0,0,0,0,0,0,0,0,2017
8,20190,9S,9S,Southern Air Inc.,2,832423,5082731,670825,,5753556,6585979,832423,5753556,6585979,1748088,10673735,1408733,0,12082468,13830556,1748088,12082468,13830556,2017
8,19805,AA,AA,American Airlines Inc.,3,195498949,63912064,23988888,47235257,135136209,330635158,196202881,135464492,331667373,301128985,101124198,36930840,79125665,217180703,518309688,302212690,217715441,519928131,2017
8,20453,ABX,ABX,ABX Air Inc,2,62859,0,0,0,0,62859,62859,0,62859,104976,0,0,0,0,104976,104976,0,104976,2017
8,19930,AS,AS,Alaska Airlines Inc.,3,44102669,0,0,508483,508483,44611152,44200173,508483,44708656,78327028,0,0,977890,977890,79304918,78479686,977890,79457576,2017
8,20409,B6,B6,JetBlue Airways,3,57803927,0,0,15149911,15149911,72953838,57803927,15149911,72953838,98122319,0,0,25717013,25717013,123839332,98122319,25717013,123839332,2017
8,21167,CP,CP,Compass Airlines,2,0,0,0,0,0,0,0,0,0,0,0,0,0,0,0,0,0,0,2017
8,19790,DL,DL,Delta Air Lines Inc.,3,190235810,81827843,38080272,23980587,143888702,334124512,191308531,143908121,335216652,303342790,130479568,60721354,38238532,229439454,532782244,306314812,229470419,535785231,2017
8,21650,EE,EE,Eastern Airlines Group Inc.,1,0,0,0,0,0,0,3760,259280,263040,0,0,0,0,0,0,6655,458926,465581,2017
8,20366,EV,EV,ExpressJet Airlines Inc.,3,4676,0,0,0,0,4676,4676,0,4676,38986,0,0,0,0,38986,38986,0,38986,2017
8,20436,F9,F9,Frontier Airlines Inc.,3,20158355,0,0,1387429,1387429,21545784,20158355,1387429,21545784,31340304,0,0,2269385,2269385,33609689,31340304,2269385,33609689,2017
8,20107,FX,FX,Federal Express Corporation,3,61773956,13913733,22147732,2162915,38224380,99998336,63066945,38686358,101753303,97692000,22382000,34996000,3823000,61201000,158893000,99798000,62038000,161836000,2017
8,20368,G4,G4,Allegiant Air,3,13992005,0,0,0,0,13992005,14662825,0,14662825,25482627,0,0,0,0,25482627,26759574,0,26759574,2017
8,20500,G7,G7,GoJet Airlines LLC d/b/a United Express,2,0,0,0,0,0,0,0,0,0,0,0,0,0,0,0,0,0,0,2017
8,20166,GFQ,GFQ,Gulf And Caribbean Cargo,1,0,0,0,0,0,0,193770,202159,395929,0,0,0,0,0,0,404453,459951,864404,2017
8,20402,GL,GL,Miami Air International,2,0,0,0,0,0,0,198577,145689,344266,0,0,0,0,0,0,464065,340468,804533,2017
8,19690,HA,HA,Hawaiian Airlines Inc.,3,15575598,0,7241567,0,7241567,22817165,15593843,7241567,22835410,24726631,0,11168139,0,11168139,35894770,24756372,11168139,35924511,2017
8,20370,KAQ,KAQ,Kalitta Air LLC,2,0,0,0,0,0,0,1061612,2918806,3980418,0,0,0,0,0,0,1859764,5702732,7562496,2017
8,21629,KD,KD,Western Global,1,0,0,0,0,0,0,1066150,845138,1911288,0,0,0,0,0,0,1977057,1470796,3447853,2017
8,21634,KH,KH,Aloha Air Cargo,1,456380,0,0,0,0,456380,456380,0,456380,723672,0,0,0,0,723672,723672,0,723672,2017
8,20372,KLQ,KLQ,Kalitta Charters II,1,0,0,0,0,0,0,146305,111532,257837,0,0,0,0,0,0,331610,260100,591710,2017
8,20169,L2,L2,Lynden Air Cargo Airlines,1,67222,0,0,0,0,67222,212215,0,212215,130671,0,0,0,0,130671,468035,0,468035,2017
8,20151,M6,M6,Amerijet International,2,0,0,0,1430894,1430894,1430894,305137,1543103,1848240,0,0,0,2594402,2594402,2594402,553254,2797852,3351106,2017
8,20398,MQ,MQ,Envoy Air,3,0,0,0,0,0,0,0,0,0,0,0,0,0,0,0,0,0,0,2017
8,20405,N8,N8,National Air Cargo Group Inc d/ba National Airlines,1,0,0,0,0,0,0,131044,759876,890920,0,0,0,0,0,0,308461,1480140,1788601,2017
8,20108,NC,NC,Northern Air Cargo Inc.,1,478688,0,0,0,0,478688,584905,3803,588708,882775,0,0,0,0,882775,1043050,5640,1048690,2017
8,20416,NK,NK,Spirit Air Lines,3,29576660,0,0,2571884,2571884,32148544,29576660,2571884,32148544,52173190,0,0,4536799,4536799,56709989,52173190,4536799,56709989,2017
8,20397,OH,OH,PSA Airlines Inc.,2,0,0,0,0,0,0,0,0,0,0,0,0,0,0,0,0,0,0,2017
8,20304,OO,OO,SkyWest Airlines Inc.,3,6940229,0,0,0,0,6940229,6940229,0,6940229,13771223,0,0,0,0,13771223,13771223,0,13771223,2017
8,20177,PFQ,PFQ,Asia Pacific,1,0,0,0,0,0,0,0,340458,340458,0,0,0,0,0,0,0,627850,627850,2017
8,20100,PO,PO,Polar Air Cargo Airways,3,3105941,712383,12660294,0,13372677,16478618,3105941,13372677,16478618,5093303,1414470,19000808,0,20415278,25508581,5093303,20415278,25508581,2017
8,19687,QX,QX,Horizon Air,2,0,0,0,0,0,0,0,0,0,0,0,0,0,0,0,0,0,0,2017
8,20422,SY,SY,Sun Country Airlines d/b/a MN Airlines,2,3917486,0,0,400866,400866,4318352,4384399,449597,4833996,6876205,0,0,777333,777333,7653538,8516861,864310,9381171,2017
8,20447,U7,U7,USA Jet Airlines Inc.,2,0,0,0,0,0,0,475410,30997,506407,0,0,0,0,0,0,822459,85294,907753,2017
8,19977,UA,UA,United Air Lines Inc.,3,150518121,75534945,56624307,26845506,159004758,309522879,151878502,159642691,311521193,236550388,119273197,89785778,44551519,253610494,490160882,238731146,254729822,493460968,2017
8,21171,VX,VX,Virgin America,3,18238682,0,0,201973,201973,18440655,18238682,201973,18440655,29420018,0,0,365903,365903,29785921,29420018,365903,29785921,2017
8,20195,WI,WI,Sky Lease Cargo,1,0,0,0,0,0,0,0,1480026,1480026,0,0,0,0,0,0,0,2778304,2778304,2017
8,20287,WP,WP,Island Air Hawaii,1,353451,0,0,0,0,353451,353451,0,353451,589892,0,0,0,0,589892,589892,0,589892,2017
8,20377,X9,X9,Omni Air International LLC,2,0,0,0,0,0,0,375705,2251549,2627254,0,0,0,0,0,0,658971,4455604,5114575,2017
8,20207,XP,XP,XTRA Airways,1,0,0,0,0,0,0,33642,248827,282469,0,0,0,0,0,0,66931,495040,561971,2017
8,20378,YV,YV,Mesa Airlines Inc.,2,0,0,0,0,0,0,0,0,0,0,0,0,0,0,0,0,0,0,2017
8,20452,YX,YX,Republic Airline,2,0,0,0,0,0,0,0,0,0,0,0,0,0,0,0,0,0,0,2017
8,20046,ZW,ZW,Air Wisconsin Airlines Corp,2,11462,0,0,0,0,11462,11462,0,11462,34733,0,0,0,0,34733,34733,0,34733,2017
8,19393,WN,WN,Southwest Airlines Co.,3,176279373,0,0,2025661,2025661,178305034,176538201,2025661,178563862,322810062,0,0,3918571,3918571,326728633,323217531,3918571,327136102,2017
9,21161,09Q,09Q,"Swift Air, LLC",1,0,0,0,0,0,0,376989,183970,560959,0,0,0,0,0,0,1013908,375840,1389748,2017
9,21352,0WQ,0WQ,Avjet Corporation,1,0,0,0,0,0,0,24343,821,25164,0,0,0,0,0,0,79844,1880,81724,2017
9,21492,1BQ,1BQ,"Dynamic Airways, LLC",1,0,0,0,0,0,0,168712,158946,327658,0,0,0,0,0,0,343770,336308,680078,2017
9,21645,23Q,23Q,Songbird Airways Inc.,1,0,0,0,0,0,0,0,0,0,0,0,0,0,0,0,0,0,0,2017
9,21652,27Q,27Q,"Jet Aviation Flight Services, Inc.",1,0,0,0,0,0,0,0,0,0,0,0,0,0,0,0,0,0,0,2017
9,20408,5V,5V,Tatonduk Outfitters Limited d/b/a Everts Air Alaska and Everts Air Cargo,1,324684,0,0,0,0,324684,409738,0,409738,803656,0,0,0,0,803656,1014181,0,1014181,2017
9,19917,5X,5X,United Parcel Service,3,35554000,10214000,18469000,2552000,31235000,66789000,35554000,31235000,66789000,64633000,17383000,30244000,4918000,52545000,117178000,64633000,52545000,117178000,2017
9,20007,5Y,5Y,Atlas Air Inc.,3,0,0,0,0,0,0,9661268,30682360,40343628,0,0,0,0,0,0,18108951,53834052,71943003,2017
9,19874,8C,8C,Air Transport International,2,0,0,0,0,0,0,26642,530443,557085,0,0,0,0,0,0,73597,1009773,1083370,2017
9,20363,9E,9E,Endeavor Air Inc.,2,0,0,0,0,0,0,0,0,0,0,0,0,0,0,0,0,0,0,2017
9,20190,9S,9S,Southern Air Inc.,2,798113,4969202,910850,0,5880052,6678165,798113,5880052,6678165,1676037,10435324,1282785,0,11718109,13394146,1676037,11718109,13394146,2017
9,19805,AA,AA,American Airlines Inc.,3,161052511,58765379,22463897,33422978,114652254,275704765,162318178,114962276,277280454,272400407,100348996,37440361,61395879,199185236,471585643,274554515,199743573,474298088,2017
9,20453,ABX,ABX,ABX Air Inc,2,79338,0,0,0,0,79338,79338,0,79338,149869,0,0,0,0,149869,149869,0,149869,2017
9,19930,AS,AS,Alaska Airlines Inc.,3,38728507,0,0,556168,556168,39284675,38818144,556168,39374312,75380569,0,0,1167204,1167204,76547773,75531736,1167204,76698940,2017
9,20409,B6,B6,JetBlue Airways,3,47706446,0,0,10398187,10398187,58104633,47711471,10398187,58109658,88684084,0,0,19329749,19329749,108013833,88702392,19329749,108032141,2017
9,21167,CP,CP,Compass Airlines,2,0,0,0,0,0,0,0,0,0,0,0,0,0,0,0,0,0,0,2017
9,19790,DL,DL,Delta Air Lines Inc.,3,157763463,71158008,34377765,18387129,123922902,281686365,159091986,124392045,283484031,276549313,124735462,60262035,32231467,217228964,493778277,280177726,218051341,498229067,2017
9,21650,EE,EE,Eastern Airlines Group Inc.,1,0,0,0,0,0,0,3680,27280,30960,0,0,0,0,0,0,6514,48286,54800,2017
9,20366,EV,EV,ExpressJet Airlines Inc.,3,3367,0,0,0,0,3367,3367,0,3367,33702,0,0,0,0,33702,33702,0,33702,2017
9,20436,F9,F9,Frontier Airlines Inc.,3,18644364,0,0,963575,963575,19607939,18645956,963575,19609531,32746353,0,0,1746851,1746851,34493204,32750676,1746851,34497527,2017
9,20107,FX,FX,Federal Express Corporation,3,56427297,13571295,21695346,2107343,37373984,93801281,57868243,37933541,95801784,100318000,23529000,36100000,4034000,63663000,163981000,103001000,64706000,167707000,2017
9,20368,G4,G4,Allegiant Air,3,9733069,0,0,0,0,9733069,10801631,0,10801631,19479514,0,0,0,0,19479514,21836029,0,21836029,2017
9,20500,G7,G7,GoJet Airlines LLC d/b/a United Express,2,0,0,0,0,0,0,0,0,0,0,0,0,0,0,0,0,0,0,2017
9,20166,GFQ,GFQ,Gulf And Caribbean Cargo,1,0,0,0,0,0,0,332970,155438,488408,0,0,0,0,0,0,831255,394749,1226004,2017
9,20402,GL,GL,Miami Air International,2,0,0,0,0,0,0,350196,244873,595069,0,0,0,0,0,0,884185,618263,1502448,2017
9,19690,HA,HA,Hawaiian Airlines Inc.,3,14313704,0,7097171,0,7097171,21410875,14350949,7097171,21448120,24143728,0,11535108,0,11535108,35678836,24211541,11535108,35746649,2017
9,20370,KAQ,KAQ,Kalitta Air LLC,2,0,0,0,0,0,0,1304493,4318036,5622529,0,0,0,0,0,0,2365409,8645681,11011090,2017
9,21629,KD,KD,Western Global,1,0,0,0,0,0,0,1138084,1229918,2368002,0,0,0,0,0,0,2233600,2315358,4548958,2017
9,21634,KH,KH,Aloha Air Cargo,1,394002,0,0,0,0,394002,394002,0,394002,657113,0,0,0,0,657113,657113,0,657113,2017
9,20372,KLQ,KLQ,Kalitta Charters II,1,0,0,0,0,0,0,112152,100746,212898,0,0,0,0,0,0,278103,229144,507247,2017
9,20169,L2,L2,Lynden Air Cargo Airlines,1,75806,0,0,0,0,75806,182767,64998,247765,161413,0,0,0,0,161413,426122,166486,592608,2017
9,20151,M6,M6,Amerijet International,2,0,0,0,1240293,1240293,1240293,342316,1334427,1676743,0,0,0,2555183,2555183,2555183,705220,2749113,3454333,2017
9,20398,MQ,MQ,Envoy Air,3,0,0,0,0,0,0,0,0,0,0,0,0,0,0,0,0,0,0,2017
9,20405,N8,N8,National Air Cargo Group Inc d/ba National Airlines,1,0,0,0,0,0,0,120917,783819,904736,0,0,0,0,0,0,428742,1757814,2186556,2017
9,20108,NC,NC,Northern Air Cargo Inc.,1,398999,0,0,0,0,398999,480499,35036,515535,777056,0,0,0,0,777056,943415,72513,1015928,2017
9,20416,NK,NK,Spirit Air Lines,3,24511823,0,0,1620184,1620184,26132007,24511823,1620184,26132007,47753559,0,0,3156419,3156419,50909978,47753559,3156419,50909978,2017
9,20397,OH,OH,PSA Airlines Inc.,2,0,0,0,0,0,0,0,0,0,0,0,0,0,0,0,0,0,0,2017
9,20304,OO,OO,SkyWest Airlines Inc.,3,7301761,0,0,0,0,7301761,7301761,0,7301761,15464047,0,0,0,0,15464047,15464047,0,15464047,2017
9,20177,PFQ,PFQ,Asia Pacific,1,0,0,0,0,0,0,0,351710,351710,0,0,0,0,0,0,0,676757,676757,2017
9,20100,PO,PO,Polar Air Cargo Airways,3,3188921,734848,12539434,0,13274282,16463203,3188921,13274282,16463203,5675448,1528605,19803787,0,21332392,27007840,5675448,21332392,27007840,2017
9,19687,QX,QX,Horizon Air,2,0,0,0,0,0,0,0,0,0,0,0,0,0,0,0,0,0,0,2017
9,20422,SY,SY,Sun Country Airlines d/b/a MN Airlines,2,2685145,0,0,104433,104433,2789578,3413449,169495,3582944,5201590,0,0,209238,209238,5410828,7636258,347897,7984155,2017
9,20447,U7,U7,USA Jet Airlines Inc.,2,0,0,0,0,0,0,560081,45806,605887,0,0,0,0,0,0,1075356,118992,1194348,2017
9,19977,UA,UA,United Air Lines Inc.,3,129304628,70602692,53711025,20407383,144721100,274025728,130827242,145614041,276441283,225464313,120805963,90967594,37327680,249101237,474565550,228145726,250690191,478835917,2017
9,21171,VX,VX,Virgin America,3,16826677,0,0,119717,119717,16946394,16826677,119717,16946394,30138996,0,0,237208,237208,30376204,30138996,237208,30376204,2017
9,20195,WI,WI,Sky Lease Cargo,1,0,0,0,0,0,0,0,1236048,1236048,0,0,0,0,0,0,0,2525795,2525795,2017
9,20310,WL,WL,"Caribbean Sun Airlines, Inc. d/b/a World Atlantic Airlines",1,0,0,0,0,0,0,10821,301463,312284,0,0,0,0,0,0,14705,409668,424373,2017
9,20287,WP,WP,Island Air Hawaii,1,251788,0,0,0,0,251788,251788,0,251788,435924,0,0,0,0,435924,435924,0,435924,2017
9,20377,X9,X9,Omni Air International LLC,2,0,0,0,0,0,0,425657,2518556,2944213,0,0,0,0,0,0,778134,4636575,5414709,2017
9,20207,XP,XP,XTRA Airways,1,0,0,0,0,0,0,188539,141557,330096,0,0,0,0,0,0,375097,281626,656723,2017
9,20378,YV,YV,Mesa Airlines Inc.,2,0,0,0,0,0,0,0,0,0,0,0,0,0,0,0,0,0,0,2017
9,20452,YX,YX,Republic Airline,2,0,0,0,0,0,0,0,0,0,0,0,0,0,0,0,0,0,0,2017
9,20046,ZW,ZW,Air Wisconsin Airlines Corp,2,14821,0,0,0,0,14821,14821,0,14821,49176,0,0,0,0,49176,49176,0,49176,2017
9,19393,WN,WN,Southwest Airlines Co.,3,153276861,0,0,1126519,1126519,154403380,153521838,1126519,154648357,300277876,0,0,2365394,2365394,302643270,300697824,2365394,303063218,2017
10,21161,09Q,09Q,"Swift Air, LLC",1,0,0,0,0,0,0,480038,1071796,1551834,0,0,0,0,0,0,1253211,2146969,3400180,2017
10,21352,0WQ,0WQ,Avjet Corporation,1,0,0,0,0,0,0,30474,0,30474,0,0,0,0,0,0,94774,0,94774,2017
10,21492,1BQ,1BQ,"Dynamic Airways, LLC",1,0,0,0,0,0,0,67409,43969,111378,0,0,0,0,0,0,225434,105320,330754,2017
10,21652,27Q,27Q,"Jet Aviation Flight Services, Inc.",1,0,0,0,0,0,0,0,0,0,0,0,0,0,0,0,0,0,0,2017
10,20408,5V,5V,Tatonduk Outfitters Limited d/b/a Everts Air Alaska and Everts Air Cargo,1,332623,0,0,0,0,332623,422285,0,422285,942483,0,0,0,0,942483,1196540,0,1196540,2017
10,19917,5X,5X,United Parcel Service,3,39485000,10752000,18681000,3171000,32604000,72089000,39485000,32604000,72089000,68589000,18726000,32510000,6059000,57295000,125884000,68589000,57295000,125884000,2017
10,20007,5Y,5Y,Atlas Air Inc.,3,0,0,0,0,0,0,10664086,31247035,41911121,0,0,0,0,0,0,19180155,57264410,76444565,2017
10,19874,8C,8C,Air Transport International,2,0,0,0,0,0,0,0,700976,700976,0,0,0,0,0,0,0,1468415,1468415,2017
10,20363,9E,9E,Endeavor Air Inc.,2,0,0,0,0,0,0,0,0,0,0,0,0,0,0,0,0,0,0,2017
10,20190,9S,9S,Southern Air Inc.,2,941594,4912815,551082,0,5463897,6405491,941594,5463897,6405491,1977347,10316912,1157272,0,11474184,13451531,1977347,11474184,13451531,2017
10,19805,AA,AA,American Airlines Inc.,3,177882996,55572279,23707221,42516792,121796292,299679288,179025054,122074563,301099617,303569587,96896454,40707475,80262364,217866293,521435880,305538597,218373178,523911775,2017
10,20453,ABX,ABX,ABX Air Inc,2,77495,0,0,0,0,77495,77495,0,77495,150339,0,0,0,0,150339,150339,0,150339,2017
10,19930,AS,AS,Alaska Airlines Inc.,3,39484617,0,0,895082,895082,40379699,39577549,895082,40472631,76035046,0,0,1843676,1843676,77878722,76195277,1843676,78038953,2017
10,20409,B6,B6,JetBlue Airways,3,52637284,0,0,11082379,11082379,63719663,52649434,11082379,63731813,96915748,0,0,20404873,20404873,117320621,96933427,20404873,117338300,2017
10,21167,CP,CP,Compass Airlines,2,0,0,0,0,0,0,0,0,0,0,0,0,0,0,0,0,0,0,2017
10,19790,DL,DL,Delta Air Lines Inc.,3,169577064,65282599,32884196,19942642,118109437,287686501,171769288,118888472,290657760,321516332,123775123,62348091,37811040,223934254,545450586,326818536,225411298,552229834,2017
10,20366,EV,EV,ExpressJet Airlines Inc.,3,0,0,0,0,0,0,0,0,0,0,0,0,0,0,0,0,0,0,2017
10,20436,F9,F9,Frontier Airlines Inc.,3,20346158,0,0,1159123,1159123,21505281,20349899,1159123,21509022,35027248,0,0,2059071,2059071,37086319,35034624,2059071,37093695,2017
10,20107,FX,FX,Federal Express Corporation,3,58624842,13630964,21754415,2123958,37509337,96134179,60232615,38334036,98566651,101539000,23944000,37963000,4189000,66096000,167635000,104379000,67722000,172101000,2017
10,20368,G4,G4,Allegiant Air,3,14882241,0,0,0,0,14882241,14985776,0,14985776,29177897,0,0,0,0,29177897,29388053,0,29388053,2017
10,20500,G7,G7,GoJet Airlines LLC d/b/a United Express,2,0,0,0,0,0,0,0,0,0,0,0,0,0,0,0,0,0,0,2017
10,20166,GFQ,GFQ,Gulf And Caribbean Cargo,1,0,0,0,0,0,0,385196,113666,498862,0,0,0,0,0,0,933314,296492,1229806,2017
10,20402,GL,GL,Miami Air International,2,0,0,0,0,0,0,404083,326323,730406,0,0,0,0,0,0,954299,770657,1724956,2017
10,19690,HA,HA,Hawaiian Airlines Inc.,3,14833229,0,7186483,0,7186483,22019712,14868907,7186483,22055390,25459396,0,12237412,0,12237412,37696808,25527012,12237412,37764424,2017
10,20370,KAQ,KAQ,Kalitta Air LLC,2,0,0,0,0,0,0,993280,4058331,5051611,0,0,0,0,0,0,1987800,8196615,10184415,2017
10,21629,KD,KD,Western Global,1,0,0,0,0,0,0,1428110,1152064,2580174,0,0,0,0,0,0,2794600,2241364,5035964,2017
10,21634,KH,KH,Aloha Air Cargo,1,420655,0,0,0,0,420655,420655,0,420655,723831,0,0,0,0,723831,723831,0,723831,2017
10,20372,KLQ,KLQ,Kalitta Charters II,1,0,0,0,0,0,0,177198,98170,275368,0,0,0,0,0,0,446912,258600,705512,2017
10,20169,L2,L2,Lynden Air Cargo Airlines,1,98769,0,0,0,0,98769,169063,41673,210736,203136,0,0,0,0,203136,376581,153027,529608,2017
10,20151,M6,M6,Amerijet International,2,0,0,0,1682370,1682370,1682370,557493,1844136,2401629,0,0,0,3328763,3328763,3328763,1103064,3648836,4751900,2017
10,20398,MQ,MQ,Envoy Air,3,0,0,0,0,0,0,0,0,0,0,0,0,0,0,0,0,0,0,2017
10,20405,N8,N8,National Air Cargo Group Inc d/ba National Airlines,1,0,0,0,0,0,0,80116,782374,862490,0,0,0,0,0,0,256199,1711400,1967599,2017
10,20108,NC,NC,Northern Air Cargo Inc.,1,378248,0,0,0,0,378248,525524,45476,571000,755648,0,0,0,0,755648,1056140,88944,1145084,2017
10,20416,NK,NK,Spirit Air Lines,3,27446594,0,0,1845395,1845395,29291989,27446594,1845395,29291989,52331623,0,0,3518562,3518562,55850185,52331623,3518562,55850185,2017
10,20397,OH,OH,PSA Airlines Inc.,2,0,0,0,0,0,0,0,0,0,0,0,0,0,0,0,0,0,0,2017
10,20304,OO,OO,SkyWest Airlines Inc.,3,7731794,0,0,0,0,7731794,7731794,0,7731794,16345559,0,0,0,0,16345559,16345559,0,16345559,2017
10,20177,PFQ,PFQ,Asia Pacific,1,0,0,0,0,0,0,0,294627,294627,0,0,0,0,0,0,0,603745,603745,2017
10,20100,PO,PO,Polar Air Cargo Airways,3,3192050,740734,11742237,0,12482971,15675021,3192050,12482971,15675021,5596611,1562863,19643853,0,21206716,26803327,5596611,21206716,26803327,2017
10,19687,QX,QX,Horizon Air,2,0,0,0,0,0,0,0,0,0,0,0,0,0,0,0,0,0,0,2017
10,20422,SY,SY,Sun Country Airlines d/b/a MN Airlines,2,3236985,0,0,225673,225673,3462658,4023896,315299,4339195,6097221,0,0,418578,418578,6515799,8684618,608765,9293383,2017
10,20447,U7,U7,USA Jet Airlines Inc.,2,0,0,0,0,0,0,479116,22944,502060,0,0,0,0,0,0,1074260,65390,1139650,2017
10,19977,UA,UA,United Air Lines Inc.,3,138940629,65982363,53845540,22087407,141915310,280855939,140728887,142684370,283413257,242693878,115361196,94965783,41521926,251848905,494542783,245860776,253280423,499141199,2017
10,21171,VX,VX,Virgin America,3,18404027,0,0,127185,127185,18531212,18404027,127185,18531212,31878308,0,0,249030,249030,32127338,31878308,249030,32127338,2017
10,20195,WI,WI,Sky Lease Cargo,1,0,0,0,0,0,0,0,2044190,2044190,0,0,0,0,0,0,0,4193979,4193979,2017
10,20310,WL,WL,"Caribbean Sun Airlines, Inc. d/b/a World Atlantic Airlines",1,0,0,0,0,0,0,44970,218030,263000,0,0,0,0,0,0,116754,566066,682820,2017
10,20377,X9,X9,Omni Air International LLC,2,0,0,0,0,0,0,412016,3695674,4107690,0,0,0,0,0,0,824292,7600324,8424616,2017
10,20378,YV,YV,Mesa Airlines Inc.,2,0,0,0,0,0,0,0,0,0,0,0,0,0,0,0,0,0,0,2017
10,20452,YX,YX,Republic Airline,2,0,0,0,0,0,0,0,0,0,0,0,0,0,0,0,0,0,0,2017
10,20046,ZW,ZW,Air Wisconsin Airlines Corp,2,12882,0,0,0,0,12882,12882,0,12882,43480,0,0,0,0,43480,43480,0,43480,2017
10,19393,WN,WN,Southwest Airlines Co.,3,164445092,0,0,1356153,1356153,165801245,164689482,1356153,166045635,318148472,0,0,2814488,2814488,320962960,318571217,2814488,321385705,2017
11,21161,09Q,09Q,"Swift Air, LLC",1,0,0,0,0,0,0,425662,274627,700289,0,0,0,0,0,0,1459328,702837,2162165,2017
11,21352,0WQ,0WQ,Avjet Corporation,1,0,0,0,0,0,0,20130,2164,22294,0,0,0,0,0,0,67032,5021,72053,2017
11,21492,1BQ,1BQ,"Dynamic Airways, LLC",1,0,0,0,0,0,0,92083,9786,101869,0,0,0,0,0,0,194265,27526,221791,2017
11,21652,27Q,27Q,"Jet Aviation Flight Services, Inc.",1,0,0,0,0,0,0,0,0,0,0,0,0,0,0,0,0,0,0,2017
11,20408,5V,5V,Tatonduk Outfitters Limited d/b/a Everts Air Alaska and Everts Air Cargo,1,320526,0,0,0,0,320526,400500,0,400500,880895,0,0,0,0,880895,1100686,0,1100686,2017
11,19917,5X,5X,United Parcel Service,3,43341000,11456000,21327000,3174000,35957000,79298000,43341000,35957000,79298000,79072000,20638000,37905000,6193000,64736000,143808000,79072000,64736000,143808000,2017
11,20007,5Y,5Y,Atlas Air Inc.,3,0,0,0,0,0,0,12285644,30871966,43157610,0,0,0,0,0,0,22284686,58308083,80592769,2017
11,19874,8C,8C,Air Transport International,2,0,0,0,0,0,0,29546,670592,700138,0,0,0,0,0,0,69443,1425396,1494839,2017
11,20363,9E,9E,Endeavor Air Inc.,2,0,0,0,0,0,0,0,0,0,0,0,0,0,0,0,0,0,0,2017
11,20190,9S,9S,Southern Air Inc.,2,981139,5030331,602727,0,5633058,6614197,981139,5633058,6614197,2060392,10563695,1265727,0,11829422,13889814,2060392,11829422,13889814,2017
11,19805,AA,AA,American Airlines Inc.,3,164455196,36201447,23177371,43746347,103125165,267580361,165155362,103307829,268463191,287656693,65606371,40939293,83636259,190181923,477838616,288883072,190531185,479414257,2017
11,20453,ABX,ABX,ABX Air Inc,2,80700,0,0,0,0,80700,80700,0,80700,151216,0,0,0,0,151216,151216,0,151216,2017
11,19930,AS,AS,Alaska Airlines Inc.,3,39310667,0,0,1107216,1107216,40417883,39393390,1107216,40500606,79419594,0,0,2230709,2230709,81650303,79566897,2230709,81797606,2017
11,20409,B6,B6,JetBlue Airways,3,51564690,0,0,11257254,11257254,62821944,51573000,11257254,62830254,96765922,0,0,21125282,21125282,117891204,96789777,21125282,117915059,2017
11,21167,CP,CP,Compass Airlines,2,0,0,0,0,0,0,0,0,0,0,0,0,0,0,0,0,0,0,2017
11,19790,DL,DL,Delta Air Lines Inc.,3,158963677,46113845,27211724,19915225,93240794,252204471,161553444,94315795,255869239,307046191,89071167,52560787,38467241,180099195,487145386,313200381,182175613,495375994,2017
11,20366,EV,EV,ExpressJet Airlines Inc.,3,2639,0,0,0,0,2639,2639,0,2639,32347,0,0,0,0,32347,32347,0,32347,2017
11,20436,F9,F9,Frontier Airlines Inc.,3,19292810,0,0,1747242,1747242,21040052,19294199,1747242,21041441,34104267,0,0,3320657,3320657,37424924,34106960,3320657,37427617,2017
11,20107,FX,FX,Federal Express Corporation,3,61473973,14068395,23062641,2190591,39321627,100795600,63070766,39955172,103025938,111765000,25830000,41516000,4420000,71766000,183531000,114704647,72971541,187676188,2017
11,20368,G4,G4,Allegiant Air,3,14306352,0,0,0,0,14306352,14354451,8898,14363349,29153559,0,0,0,0,29153559,29255555,24611,29280166,2017
11,20500,G7,G7,GoJet Airlines LLC d/b/a United Express,2,0,0,0,0,0,0,0,0,0,0,0,0,0,0,0,0,0,0,2017
11,20166,GFQ,GFQ,Gulf And Caribbean Cargo,1,0,0,0,0,0,0,281283,141103,422386,0,0,0,0,0,0,662901,342042,1004943,2017
11,20402,GL,GL,Miami Air International,2,0,0,0,0,0,0,450332,276545,726877,0,0,0,0,0,0,1132964,695743,1828707,2017
11,19690,HA,HA,Hawaiian Airlines Inc.,3,14429547,0,7115377,0,7115377,21544924,14485732,7115377,21601109,26147856,0,12574303,0,12574303,38722159,26252271,12574303,38826574,2017
11,20370,KAQ,KAQ,Kalitta Air LLC,2,0,0,0,0,0,0,1388025,4150608,5538633,0,0,0,0,0,0,2630232,8168366,10798598,2017
11,21629,KD,KD,Western Global,1,0,0,0,0,0,0,1553469,2197263,3750732,0,0,0,0,0,0,3154141,2706810,5860951,2017
11,21634,KH,KH,Aloha Air Cargo,1,434131,0,0,0,0,434131,434131,0,434131,792696,0,0,0,0,792696,792696,0,792696,2017
11,20372,KLQ,KLQ,Kalitta Charters II,1,0,0,0,0,0,0,190769,136923,327692,0,0,0,0,0,0,466801,359410,826211,2017
11,20169,L2,L2,Lynden Air Cargo Airlines,1,103720,0,0,0,0,103720,198203,33928,232131,216688,0,0,0,0,216688,481893,111575,593468,2017
11,20151,M6,M6,Amerijet International,2,0,0,0,1575771,1575771,1575771,491179,1609443,2100622,0,0,0,3154843,3154843,3154843,983387,3222258,4205645,2017
11,20398,MQ,MQ,Envoy Air,3,0,0,0,0,0,0,0,0,0,0,0,0,0,0,0,0,0,0,2017
11,20405,N8,N8,National Air Cargo Group Inc d/ba National Airlines,1,0,0,0,0,0,0,135956,202354,338310,0,0,0,0,0,0,351156,461739,812895,2017
11,20108,NC,NC,Northern Air Cargo Inc.,1,358489,0,0,0,0,358489,460916,24033,484949,756932,0,0,0,0,756932,974974,61612,1036586,2017
11,20416,NK,NK,Spirit Air Lines,3,26962585,0,0,2186156,2186156,29148741,26962585,2186156,29148741,52974522,0,0,4295231,4295231,57269753,52974522,4295231,57269753,2017
11,20397,OH,OH,PSA Airlines Inc.,2,0,0,0,0,0,0,0,0,0,0,0,0,0,0,0,0,0,0,2017
11,20304,OO,OO,SkyWest Airlines Inc.,3,7368010,0,0,0,0,7368010,7368010,0,7368010,16037156,0,0,0,0,16037156,16037156,0,16037156,2017
11,20177,PFQ,PFQ,Asia Pacific,1,0,0,0,0,0,0,0,285432,285432,0,0,0,0,0,0,0,608385,608385,2017
11,20100,PO,PO,Polar Air Cargo Airways,3,3159467,853124,13338847,0,14191971,17351438,3159467,14191971,17351438,5818580,1928303,22287609,0,24215912,30034492,5818580,24215912,30034492,2017
11,19687,QX,QX,Horizon Air,2,0,0,0,0,0,0,0,0,0,0,0,0,0,0,0,0,0,0,2017
11,20422,SY,SY,Sun Country Airlines d/b/a MN Airlines,2,3456206,0,0,283735,283735,3739941,4309279,367539,4676818,6778756,0,0,591807,591807,7370563,9431491,762817,10194308,2017
11,20447,U7,U7,USA Jet Airlines Inc.,2,0,0,0,0,0,0,599079,51829,650908,0,0,0,0,0,0,1153287,144038,1297325,2017
11,19977,UA,UA,United Air Lines Inc.,3,129510940,52016407,51478026,26621612,130116045,259626985,130657305,130709589,261366894,232155676,94421284,92685635,50252588,237359507,469515183,234222637,238439553,472662190,2017
11,21171,VX,VX,Virgin America,3,18063514,0,0,221560,221560,18285074,18063514,221560,18285074,32876280,0,0,457117,457117,33333397,32876280,457117,33333397,2017
11,20195,WI,WI,Sky Lease Cargo,1,0,0,0,0,0,0,0,2122549,2122549,0,0,0,0,0,0,0,4404950,4404950,2017
11,20310,WL,WL,"Caribbean Sun Airlines, Inc. d/b/a World Atlantic Airlines",1,0,0,0,0,0,0,31717,68597,100314,0,0,0,0,0,0,127899,276618,404517,2017
11,20377,X9,X9,Omni Air International LLC,2,0,0,0,0,0,0,367513,2438271,2805784,0,0,0,0,0,0,766248,5296689,6062937,2017
11,20207,XP,XP,XTRA Airways,1,0,0,0,0,0,0,388236,121124,509360,0,0,0,0,0,0,953478,409988,1363466,2017
11,20378,YV,YV,Mesa Airlines Inc.,2,0,0,0,0,0,0,0,0,0,0,0,0,0,0,0,0,0,0,2017
11,20452,YX,YX,Republic Airline,2,0,0,0,0,0,0,0,0,0,0,0,0,0,0,0,0,0,0,2017
11,20046,ZW,ZW,Air Wisconsin Airlines Corp,2,12089,0,0,0,0,12089,12089,0,12089,41322,0,0,0,0,41322,41322,0,41322,2017
11,19393,WN,WN,Southwest Airlines Co.,3,163758519,0,0,1708918,1708918,165467437,164027708,1708918,165736626,323863351,0,0,3672437,3672437,327535788,324347177,3672437,328019614,2017
12,21161,09Q,09Q,"Swift Air, LLC",1,0,0,0,0,0,0,467179,631602,1098781,0,0,0,0,0,0,1274547,1247085,2521632,2017
12,21352,0WQ,0WQ,Avjet Corporation,1,0,0,0,0,0,0,14504,0,14504,0,0,0,0,0,0,49895,0,49895,2017
12,21652,27Q,27Q,"Jet Aviation Flight Services, Inc.",1,0,0,0,0,0,0,0,0,0,0,0,0,0,0,0,0,0,0,2017
12,20408,5V,5V,Tatonduk Outfitters Limited d/b/a Everts Air Alaska and Everts Air Cargo,1,247779,0,0,0,0,247779,347211,0,347211,646688,0,0,0,0,646688,906200,0,906200,2017
12,19917,5X,5X,United Parcel Service,3,51162000,10427000,19175000,2705000,32307000,83469000,51162000,32307000,83469000,95890000,19743000,36079000,5462000,61284000,157174000,95890000,61284000,157174000,2017
12,20007,5Y,5Y,Atlas Air Inc.,3,0,0,0,0,0,0,13925514,28078125,42003639,0,0,0,0,0,0,25673919,55983370,81657289,2017
12,19874,8C,8C,Air Transport International,2,0,0,0,0,0,0,79996,686497,766493,0,0,0,0,0,0,233571,1480423,1713994,2017
12,20363,9E,9E,Endeavor Air Inc.,2,0,0,0,0,0,0,0,0,0,0,0,0,0,0,0,0,0,0,2017
12,20190,9S,9S,Southern Air Inc.,2,949569,5108849,692415,0,5801264,6750833,949569,5801264,6750833,1994095,10728583,1454072,0,12182655,14176750,1994095,12182655,14176750,2017
12,19805,AA,AA,American Airlines Inc.,3,180095269,40593357,23967952,51351668,115912977,296008246,180795497,116104407,296899904,326993567,75866590,44608375,102357885,222832850,549826417,328278822,223215477,551494299,2017
12,20453,ABX,ABX,ABX Air Inc,2,39054,0,0,0,0,39054,39054,0,39054,81623,0,0,0,0,81623,81623,0,81623,2017
12,19930,AS,AS,Alaska Airlines Inc.,3,41793249,0,0,1297216,1297216,43090465,41859679,1297216,43156895,86010876,0,0,2816822,2816822,88827698,86131679,2816822,88948501,2017
12,20409,B6,B6,JetBlue Airways,3,53994663,0,0,13882485,13882485,67877148,53994663,13882485,67877148,105741770,0,0,27187105,27187105,132928875,105741770,27187105,132928875,2017
12,21167,CP,CP,Compass Airlines,2,0,0,0,0,0,0,0,0,0,0,0,0,0,0,0,0,0,0,2017
12,19790,DL,DL,Delta Air Lines Inc.,3,159887908,49451426,29891440,26321911,105664777,265552685,162230141,105775680,268005821,313734423,97034322,58653426,51649243,207336991,521071414,319643796,207554607,527198403,2017
12,20366,EV,EV,ExpressJet Airlines Inc.,3,0,0,0,0,0,0,0,0,0,0,0,0,0,0,0,0,0,0,2017
12,20436,F9,F9,Frontier Airlines Inc.,3,19895987,0,0,2308229,2308229,22204216,19896845,2308229,22205074,36783323,0,0,4510976,4510976,41294299,36784986,4510976,41295962,2017
12,20107,FX,FX,Federal Express Corporation,3,70121080,12746566,22804176,1914119,37464861,107585941,71795060,37949350,109744410,132145000,22274000,43212000,3759000,69245000,201390000,135310000,70140810,205450810,2017
12,20368,G4,G4,Allegiant Air,3,16056749,0,0,0,0,16056749,16159401,0,16159401,33374464,0,0,0,0,33374464,33597781,0,33597781,2017
12,20500,G7,G7,GoJet Airlines LLC d/b/a United Express,2,0,0,0,0,0,0,0,0,0,0,0,0,0,0,0,0,0,0,2017
12,20166,GFQ,GFQ,Gulf And Caribbean Cargo,1,0,0,0,0,0,0,71086,117349,188435,0,0,0,0,0,0,157361,288440,445801,2017
12,20402,GL,GL,Miami Air International,2,0,0,0,0,0,0,456854,76549,533403,0,0,0,0,0,0,1213975,203407,1417382,2017
12,19690,HA,HA,Hawaiian Airlines Inc.,3,15575930,0,7244096,0,7244096,22820026,15632560,7244096,22876656,28852246,0,13434967,0,13434967,42287213,28960951,13434967,42395918,2017
12,20370,KAQ,KAQ,Kalitta Air LLC,2,0,0,0,0,0,0,3097387,2228975,5326362,0,0,0,0,0,0,5863789,4543187,10406976,2017
12,21629,KD,KD,Western Global,1,0,0,0,0,0,0,766089,588922,1355011,0,0,0,0,0,0,1678803,1263100,2941903,2017
12,21634,KH,KH,Aloha Air Cargo,1,497855,0,0,0,0,497855,497855,0,497855,932356,0,0,0,0,932356,932356,0,932356,2017
12,20372,KLQ,KLQ,Kalitta Charters II,1,0,0,0,0,0,0,112333,62186,174519,0,0,0,0,0,0,270450,147252,417702,2017
12,20169,L2,L2,Lynden Air Cargo Airlines,1,104692,0,0,0,0,104692,218302,25972,244274,238122,0,0,0,0,238122,543257,95321,638578,2017
12,20151,M6,M6,Amerijet International,2,0,0,0,1190040,1190040,1190040,926649,1250204,2176853,0,0,0,2460039,2460039,2460039,1915560,2584409,4499969,2017
12,20398,MQ,MQ,Envoy Air,3,0,0,0,0,0,0,0,0,0,0,0,0,0,0,0,0,0,0,2017
12,20405,N8,N8,National Air Cargo Group Inc d/ba National Airlines,1,0,0,0,0,0,0,51488,206112,257600,0,0,0,0,0,0,131834,464736,596570,2017
12,20108,NC,NC,Northern Air Cargo Inc.,1,353686,0,0,0,0,353686,448220,13148,461368,737539,0,0,0,0,737539,926718,27658,954376,2017
12,20416,NK,NK,Spirit Air Lines,3,28026701,0,0,2371022,2371022,30397723,28026701,2371022,30397723,57242637,0,0,4842653,4842653,62085290,57242637,4842653,62085290,2017
12,20397,OH,OH,PSA Airlines Inc.,2,0,0,0,0,0,0,0,0,0,0,0,0,0,0,0,0,0,0,2017
12,20304,OO,OO,SkyWest Airlines Inc.,3,7379409,0,0,0,0,7379409,7379409,0,7379409,16611712,0,0,0,0,16611712,16611712,0,16611712,2017
12,20177,PFQ,PFQ,Asia Pacific,1,0,0,0,0,0,0,0,402089,402089,0,0,0,0,0,0,0,883320,883320,2017
12,20100,PO,PO,Polar Air Cargo Airways,3,3397125,889389,13514065,0,14403454,17800579,3397125,14403454,17800579,6445991,2044557,24422943,0,26467500,32913491,6445991,26467500,32913491,2017
12,19687,QX,QX,Horizon Air,2,0,0,0,0,0,0,0,0,0,0,0,0,0,0,0,0,0,0,2017
12,20422,SY,SY,Sun Country Airlines d/b/a MN Airlines,2,4031941,0,0,753869,753869,4785810,4786840,826259,5613099,7858136,0,0,1501121,1501121,9359257,9832369,1620217,11452586,2017
12,20447,U7,U7,USA Jet Airlines Inc.,2,0,0,0,0,0,0,787435,23144,810579,0,0,0,0,0,0,1560854,65718,1626572,2017
12,19977,UA,UA,United Air Lines Inc.,3,135539469,52174174,53581048,31927490,137682712,273222181,136715783,138033448,274749231,250827691,97994217,101215432,62518217,261727866,512555557,253010171,262398419,515408590,2017
12,21171,VX,VX,Virgin America,3,18583750,0,0,287490,287490,18871240,18583750,287490,18871240,34677595,0,0,607905,607905,35285500,34677595,607905,35285500,2017
12,20195,WI,WI,Sky Lease Cargo,1,0,0,0,0,0,0,80911,1840608,1921519,0,0,0,0,0,0,182387,3893683,4076070,2017
12,20377,X9,X9,Omni Air International LLC,2,0,0,0,0,0,0,424828,1524551,1949379,0,0,0,0,0,0,840120,2999909,3840029,2017
12,20207,XP,XP,XTRA Airways,1,0,0,0,0,0,0,264806,201999,466805,0,0,0,0,0,0,617481,549756,1167237,2017
12,20378,YV,YV,Mesa Airlines Inc.,2,0,0,0,0,0,0,0,0,0,0,0,0,0,0,0,0,0,0,2017
12,20452,YX,YX,Republic Airline,2,0,0,0,0,0,0,0,0,0,0,0,0,0,0,0,0,0,0,2017
12,20046,ZW,ZW,Air Wisconsin Airlines Corp,2,43910,0,0,0,0,43910,43910,0,43910,145002,0,0,0,0,145002,145002,0,145002,2017
12,19393,WN,WN,Southwest Airlines Co.,3,167238506,0,0,2227037,2227037,169465543,167488187,2227037,169715224,324626967,0,0,4912097,4912097,329539064,325085161,4912097,329997258,2017
1,21236,0JQ,0JQ,Vision Airlines,1,0,0,0,0,0,0,113588,20237,133825,0,0,0,0,0,0,290954,87265,378219,2015
1,21352,0WQ,0WQ,Avjet Corporation,1,0,0,0,0,0,0,149758,23240,172998,0,0,0,0,0,0,515168,61121,576289,2015
1,20397,OH,16,PSA Airlines Inc.,2,0,0,0,0,0,0,0,0,0,0,0,0,0,0,0,0,0,0,2015
1,21645,23Q,23Q,Sky King Inc.,1,0,0,0,0,0,0,0,0,0,0,0,0,0,0,0,0,0,0,2015
1,20408,5V,5V,Tatonduk Outfitters Limited d/b/a Everts Air Alaska and Everts Air Cargo,1,248419,0,0,0,0,248419,312227,0,312227,747989,0,0,0,0,747989,940115,0,940115,2015
1,19917,5X,5X,United Parcel Service,3,30696000,9987000,16233000,2782000,29002000,59698000,30696000,29002000,59698000,50705000,15919000,29010000,4971000,49900000,100605000,50705000,49900000,100605000,2015
1,20007,5Y,5Y,Atlas Air Inc.,3,0,0,0,0,0,0,4710772,21042723,25753495,0,0,0,0,0,0,10592898,50069690,60662588,2015
1,19874,8C,8C,Air Transport International,2,0,0,0,0,0,0,14998,662346,677344,0,0,0,0,0,0,52103,2254606,2306709,2015
1,20363,9E,9E,Endeavor Air Inc.,2,0,0,0,0,0,0,0,0,0,0,0,0,0,0,0,0,0,0,2015
1,20190,9S,9S,Southern Air Inc.,2,0,1951180,1971252,0,3922432,3922432,0,3922432,3922432,0,7063272,7135932,0,14199204,14199204,0,14199204,14199204,2015
1,19805,AA,AA,American Airlines Inc.,3,110155124,24287442,17010699,48202691,89500832,199655956,110395239,89593784,199989023,195473294,38616773,29544866,86877338,155038977,350512271,195881242,155240499,351121741,2015
1,20453,ABX,ABX,ABX Air Inc,2,25773,0,0,0,0,25773,25773,0,25773,47791,0,0,0,0,47791,47791,0,47791,2015
1,19930,AS,AS,Alaska Airlines Inc.,3,32978180,0,0,1251059,1251059,34229239,33038474,1251059,34289533,65623892,0,0,2215594,2215594,67839486,65732649,2215594,67948243,2015
1,20409,B6,B6,JetBlue Airways,3,44725469,0,0,10140197,10140197,54865666,44725469,10140197,54865666,90381642,0,0,20491403,20491403,110873045,90381642,20491403,110873045,2015
1,21167,CP,CP,Compass Airlines,2,0,0,0,0,0,0,0,0,0,0,0,0,0,0,0,0,0,0,2015
1,19790,DL,DL,Delta Air Lines Inc.,3,128505448,52573705,42509341,30945052,126028098,254533546,130116496,127400046,257516542,321234269,131422254,106263644,77355563,315041461,636275730,325715496,318471018,644186514,2015
1,20366,EV,EV,ExpressJet Airlines Inc.,3,102060,0,0,0,0,102060,102060,0,102060,323056,0,0,0,0,323056,323056,0,323056,2015
1,20436,F9,F9,Frontier Airlines Inc.,3,12592758,0,0,2284310,2284310,14877068,12669754,2300570,14970324,23101489,0,0,4549847,4549847,27651336,23283640,4585615,27869255,2015
1,20203,FCQ,FCQ,Falcon Air Express,1,0,0,0,0,0,0,0,114398,114398,0,0,0,0,0,0,0,265402,265402,2015
1,20107,FX,FX,Federal Express Corporation,3,56990489,11439989,19820050,2154046,33414085,90404574,58367165,34155405,92522570,96924000,21150000,41200000,4594000,66944000,163868000,99393000,68733000,168126000,2015
1,20368,G4,G4,Allegiant Air,2,10111041,0,0,0,0,10111041,10542221,0,10542221,19132987,0,0,0,0,19132987,20000259,0,20000259,2015
1,20500,G7,G7,GoJet Airlines LLC d/b/a United Express,2,0,0,0,0,0,0,0,0,0,0,0,0,0,0,0,0,0,0,2015
1,20166,GFQ,GFQ,Gulf And Caribbean Cargo,1,0,0,0,0,0,0,51222,112409,163631,0,0,0,0,0,0,116655,260061,376716,2015
1,20402,GL,GL,Miami Air International,2,0,0,0,0,0,0,352524,329418,681942,0,0,0,0,0,0,844471,789123,1633594,2015
1,19690,HA,HA,Hawaiian Airlines Inc.,3,13589456,0,6143375,0,6143375,19732831,13687831,6160141,19847972,25405720,0,12708895,0,12708895,38114615,25605676,12740628,38346304,2015
1,20310,WL,K8,"Caribbean Sun Airlines, Inc. d/b/a World Atlantic Airlines",1,0,0,0,0,0,0,27448,160956,188404,0,0,0,0,0,0,52700,309033,361733,2015
1,20370,KAQ,KAQ,Kalitta Air LLC,2,0,0,0,0,0,0,522211,1894420,2416631,0,0,0,0,0,0,977220,4084550,5061770,2015
1,21629,KD,KD,Western Global,1,0,0,0,0,0,0,28288,16791,45079,0,0,0,0,0,0,51547,58373,109920,2015
1,21634,KH,KH,Aloha Air Cargo,1,469255,0,0,0,0,469255,469255,0,469255,790721,0,0,0,0,790721,790721,0,790721,2015
1,20372,KLQ,KLQ,Kalitta Charters II,1,0,0,0,0,0,0,99972,40900,140872,0,0,0,0,0,0,243506,85454,328960,2015
1,20169,L2,L2,Lynden Air Cargo Airlines,1,78107,0,0,0,0,78107,101851,0,101851,166748,0,0,0,0,166748,229402,0,229402,2015
1,20151,M6,M6,Amerijet International,2,0,0,0,1335976,1335976,1335976,215314,1476051,1691365,0,0,0,2394275,2394275,2394275,385876,2645311,3031187,2015
1,20398,MQ,MQ,Envoy Air,3,0,0,0,0,0,0,0,0,0,0,0,0,0,0,0,0,0,0,2015
1,20405,N8,MRQ,"National Air Cargo Group, Inc. d/b/a Murray Air",1,0,0,0,0,0,0,0,410414,410414,0,0,0,0,0,0,0,1264265,1264265,2015
1,20108,NC,NC,Northern Air Cargo Inc.,1,302864,0,0,0,0,302864,329481,0,329481,558213,0,0,0,0,558213,606305,0,606305,2015
1,20416,NK,NK,Spirit Air Lines,3,17117251,0,0,1923270,1923270,19040521,17117251,1923270,19040521,34434751,0,0,3869039,3869039,38303790,34434751,3869039,38303790,2015
1,20304,OO,OO,SkyWest Airlines Inc.,3,4128871,0,0,0,0,4128871,4128871,0,4128871,8969786,0,0,0,0,8969786,8969786,0,8969786,2015
1,20177,PFQ,PFQ,Asia Pacific,1,0,0,0,0,0,0,0,332961,332961,0,0,0,0,0,0,0,862055,862055,2015
1,20100,PO,PO,Polar Air Cargo Airways,3,2545828,888316,10920534,0,11808850,14354678,2545828,11808850,14354678,4488091,2039193,20059074,0,22098267,26586358,4488091,22098267,26586358,2015
1,20149,PRQ,PRQ,Florida West Airlines Inc.,1,0,0,0,0,0,0,0,0,0,0,0,0,0,0,0,0,0,0,2015
1,19687,QX,QX,Horizon Air,2,0,0,0,0,0,0,0,0,0,0,0,0,0,0,0,0,0,0,2015
1,20448,S5,S5,Shuttle America Corp.,2,6301599,0,0,0,0,6301599,6301599,0,6301599,10206564,0,0,0,0,10206564,10206564,0,10206564,2015
1,20422,SY,SY,Sun Country Airlines d/b/a MN Airlines,2,2756723,0,0,1323171,1323171,4079894,3243140,1586518,4829658,4990272,0,0,2483088,2483088,7473360,6151014,3000427,9151441,2015
1,20447,U7,U7,USA Jet Airlines Inc.,2,0,0,0,0,0,0,236043,8635,244678,0,0,0,0,0,0,413257,25046,438303,2015
1,19977,UA,UA,United Air Lines Inc.,3,107320509,52708715,56211091,28022429,136942235,244262744,108316645,137472732,245789377,187329301,98856737,106386576,52599803,257843116,445172417,189982976,258846726,448829702,2015
1,20355,US,US,US Airways Inc.,3,69739550,10615705,0,7509239,18124944,87864494,70101076,18215087,88316163,120874399,19367563,0,13620008,32987571,153861970,121510869,33158438,154669307,2015
1,21171,VX,VX,Virgin America,3,12398088,0,0,152809,152809,12550897,12441427,152809,12594236,23774320,0,0,272458,272458,24046778,23862346,272458,24134804,2015
1,20308,WE,WE,Centurion Cargo Inc.,2,0,0,0,0,0,0,0,354916,354916,0,0,0,0,0,0,0,589170,589170,2015
1,20195,WI,WI,Sky Lease Cargo,1,0,0,0,0,0,0,0,0,0,0,0,0,0,0,0,0,0,0,2015
1,20287,WP,WP,Island Air Hawaii,1,150568,0,0,0,0,150568,150568,0,150568,328845,0,0,0,0,328845,328845,0,328845,2015
1,20377,X9,X9,Omni Air Express,2,0,0,0,0,0,0,387380,2409067,2796447,0,0,0,0,0,0,819859,8121133,8940992,2015
1,20207,XP,XP,XTRA Airways,1,0,0,0,0,0,0,83607,188572,272179,0,0,0,0,0,0,288444,650573,939017,2015
1,20378,YV,YV,Mesa Airlines Inc.,2,0,0,0,0,0,0,0,0,0,0,0,0,0,0,0,0,0,0,2015
1,20452,YX,YX,Republic Airlines,2,13863113,0,0,0,0,13863113,13863113,0,13863113,24606382,0,0,0,0,24606382,24606382,0,24606382,2015
1,20046,ZW,ZW,Air Wisconsin Airlines Corp,2,6472639,0,0,0,0,6472639,6472639,0,6472639,13048498,0,0,0,0,13048498,13048498,0,13048498,2015
1,19393,WN,WN,Southwest Airlines Co.,3,142391393,0,0,807870,807870,143199263,142638841,807870,143446711,277084552,0,0,1556082,1556082,278640634,277572951,1556082,279129033,2015
2,21236,0JQ,0JQ,Vision Airlines,1,0,0,0,0,0,0,84948,29688,114636,0,0,0,0,0,0,210221,76796,287017,2015
2,21352,0WQ,0WQ,Avjet Corporation,1,0,0,0,0,0,0,140626,9383,150009,0,0,0,0,0,0,450003,49918,499921,2015
2,20397,OH,16,PSA Airlines Inc.,2,0,0,0,0,0,0,0,0,0,0,0,0,0,0,0,0,0,0,2015
2,21645,23Q,23Q,Sky King Inc.,1,0,0,0,0,0,0,0,0,0,0,0,0,0,0,0,0,0,0,2015
2,20408,5V,5V,Tatonduk Outfitters Limited d/b/a Everts Air Alaska and Everts Air Cargo,1,237005,0,0,0,0,237005,298662,0,298662,644031,0,0,0,0,644031,811576,0,811576,2015
2,19917,5X,5X,United Parcel Service,3,29373000,8677000,13343000,2802000,24822000,54195000,29373000,24822000,54195000,51153000,12849000,21695000,5107000,39651000,90804000,51153000,39651000,90804000,2015
2,20007,5Y,5Y,Atlas Air Inc.,3,0,0,0,0,0,0,5079212,21385554,26464766,0,0,0,0,0,0,11466813,47011189,58478002,2015
2,19874,8C,8C,Air Transport International,2,0,0,0,0,0,0,9496,628749,638245,0,0,0,0,0,0,30006,1912606,1942612,2015
2,20363,9E,9E,Endeavor Air Inc.,2,0,0,0,0,0,0,0,0,0,0,0,0,0,0,0,0,0,0,2015
2,20190,9S,9S,Southern Air Inc.,2,0,2308955,2205069,0,4514024,4514024,0,4514024,4514024,0,8358417,7982350,0,16340767,16340767,0,16340767,16340767,2015
2,19805,AA,AA,American Airlines Inc.,3,97298868,21804292,14933053,42638653,79375998,176674866,97576429,79438951,177015380,172130135,31961400,23558175,81665381,137184956,309315091,172575868,137295310,309871178,2015
2,20453,ABX,ABX,ABX Air Inc,2,61286,0,0,0,0,61286,61286,0,61286,131055,0,0,0,0,131055,131055,0,131055,2015
2,19930,AS,AS,Alaska Airlines Inc.,3,30082836,0,0,1052155,1052155,31134991,30128072,1052155,31180227,58936604,0,0,2015150,2015150,60951754,59015538,2015150,61030688,2015
2,20409,B6,B6,JetBlue Airways,3,40953104,0,0,8624607,8624607,49577711,40953104,8624607,49577711,83605184,0,0,17607013,17607013,101212197,83605184,17607013,101212197,2015
2,21167,CP,CP,Compass Airlines,2,0,0,0,0,0,0,0,0,0,0,0,0,0,0,0,0,0,0,2015
2,19790,DL,DL,Delta Air Lines Inc.,3,120217946,46053307,36981289,27305287,110339883,230557829,121680165,111655231,233335396,532108156,203840949,163686422,120858546,488385917,1020494073,538314852,494207904,1032522756,2015
2,20366,EV,EV,ExpressJet Airlines Inc.,3,86846,0,0,0,0,86846,86846,0,86846,261655,0,0,0,0,261655,261655,0,261655,2015
2,20436,F9,F9,Frontier Airlines Inc.,3,10934023,0,0,2362775,2362775,13296798,10984122,2380002,13364124,20297347,0,0,4755014,4755014,25052361,20407891,4789828,25197719,2015
2,20203,FCQ,FCQ,Falcon Air Express,1,0,0,0,0,0,0,36398,0,36398,0,0,0,0,0,0,97551,0,97551,2015
2,20107,FX,FX,Federal Express Corporation,3,53283824,11008730,17631568,1972234,30612532,83896356,55003750,31402153,86405903,91174000,19335000,29633000,4035000,53003000,144177000,94206000,54656000,148862000,2015
2,20368,G4,G4,Allegiant Air,2,10381712,0,0,0,0,10381712,10759142,0,10759142,20330861,0,0,0,0,20330861,21141186,0,21141186,2015
2,20500,G7,G7,GoJet Airlines LLC d/b/a United Express,2,0,0,0,0,0,0,0,0,0,0,0,0,0,0,0,0,0,0,2015
2,20166,GFQ,GFQ,Gulf And Caribbean Cargo,1,0,0,0,0,0,0,182446,173954,356400,0,0,0,0,0,0,444142,441979,886121,2015
2,20402,GL,GL,Miami Air International,2,0,0,0,0,0,0,334987,209777,544764,0,0,0,0,0,0,842827,527796,1370623,2015
2,19690,HA,HA,Hawaiian Airlines Inc.,3,12228264,0,5484126,0,5484126,17712390,12290269,5509222,17799491,21830379,0,9863653,0,9863653,31694032,21937043,9920873,31857916,2015
2,20310,WL,K8,"Caribbean Sun Airlines, Inc. d/b/a World Atlantic Airlines",1,0,0,0,0,0,0,35508,206716,242224,0,0,0,0,0,0,68293,397581,465874,2015
2,20370,KAQ,KAQ,Kalitta Air LLC,2,0,0,0,0,0,0,1317997,3564308,4882305,0,0,0,0,0,0,2521290,6500657,9021947,2015
2,21629,KD,KD,Western Global,1,0,0,0,0,0,0,0,0,0,0,0,0,0,0,0,0,0,0,2015
2,21634,KH,KH,Aloha Air Cargo,1,403514,0,0,0,0,403514,403514,0,403514,710735,0,0,0,0,710735,710735,0,710735,2015
2,20372,KLQ,KLQ,Kalitta Charters II,1,0,0,0,0,0,0,182243,43199,225442,0,0,0,0,0,0,447767,103645,551412,2015
2,20169,L2,L2,Lynden Air Cargo Airlines,1,77962,0,0,0,0,77962,113361,0,113361,177704,0,0,0,0,177704,285725,0,285725,2015
2,20151,M6,M6,Amerijet International,2,0,0,0,1362157,1362157,1362157,237776,1435829,1673605,0,0,0,2624728,2624728,2624728,458168,2766686,3224854,2015
2,20398,MQ,MQ,Envoy Air,3,0,0,0,0,0,0,0,0,0,0,0,0,0,0,0,0,0,0,2015
2,20405,N8,MRQ,"National Air Cargo Group, Inc. d/b/a Murray Air",1,0,0,0,0,0,0,0,932050,932050,0,0,0,0,0,0,0,2522478,2522478,2015
2,20108,NC,NC,Northern Air Cargo Inc.,1,298456,0,0,0,0,298456,332106,14764,346870,578954,0,0,0,0,578954,646134,30516,676650,2015
2,20416,NK,NK,Spirit Air Lines,3,15936475,0,0,1653453,1653453,17589928,15936475,1653453,17589928,26120996,0,0,2710125,2710125,28831121,26120996,2710125,28831121,2015
2,20304,OO,OO,SkyWest Airlines Inc.,3,3725601,0,0,0,0,3725601,3725601,0,3725601,8198360,0,0,0,0,8198360,8198360,0,8198360,2015
2,20177,PFQ,PFQ,Asia Pacific,1,0,0,0,0,0,0,0,328123,328123,0,0,0,0,0,0,0,796900,796900,2015
2,20100,PO,PO,Polar Air Cargo Airways,3,2407727,572008,9444663,0,10016671,12424398,2407727,10016671,12424398,4471547,1384061,15385311,0,16769372,21240919,4471547,16769372,21240919,2015
2,20149,PRQ,PRQ,Florida West Airlines Inc.,1,0,0,0,0,0,0,0,0,0,0,0,0,0,0,0,0,0,0,2015
2,19687,QX,QX,Horizon Air,2,0,0,0,0,0,0,0,0,0,0,0,0,0,0,0,0,0,0,2015
2,20448,S5,S5,Shuttle America Corp.,2,5497778,0,0,0,0,5497778,5497778,0,5497778,9620083,0,0,0,0,9620083,9620083,0,9620083,2015
2,20422,SY,SY,Sun Country Airlines d/b/a MN Airlines,2,2625619,0,0,1831247,1831247,4456866,2907461,2047265,4954726,4992997,0,0,3639409,3639409,8632406,5659510,4125585,9785095,2015
2,20447,U7,U7,USA Jet Airlines Inc.,2,0,0,0,0,0,0,291480,912,292392,0,0,0,0,0,0,547982,2401,550383,2015
2,19977,UA,UA,United Air Lines Inc.,3,99629733,47251755,48977839,24952659,121182253,220811986,100583635,121857919,222441554,171050900,80081587,83423944,44361951,207867482,378918382,172659643,209019702,381679345,2015
2,20355,US,US,US Airways Inc.,3,62228114,8943149,0,6663234,15606383,77834497,62630489,15669706,78300195,104324153,15221159,0,11764288,26985447,131309600,104998541,27097893,132096434,2015
2,21171,VX,VX,Virgin America,3,10780992,0,0,143659,143659,10924651,10884444,143659,11028103,19633001,0,0,275440,275440,19908441,19821416,275440,20096856,2015
2,20308,WE,WE,Centurion Cargo Inc.,2,0,0,0,0,0,0,0,416683,416683,0,0,0,0,0,0,0,704291,704291,2015
2,20195,WI,WI,Sky Lease Cargo,1,0,0,0,0,0,0,0,0,0,0,0,0,0,0,0,0,0,0,2015
2,20287,WP,WP,Island Air Hawaii,1,142475,0,0,0,0,142475,142475,0,142475,290526,0,0,0,0,290526,290526,0,290526,2015
2,20377,X9,X9,Omni Air Express,2,0,0,0,0,0,0,355811,2289076,2644887,0,0,0,0,0,0,724224,6911696,7635920,2015
2,20207,XP,XP,XTRA Airways,1,0,0,0,0,0,0,78986,226490,305476,0,0,0,0,0,0,225900,647761,873661,2015
2,20378,YV,YV,Mesa Airlines Inc.,2,0,0,0,0,0,0,0,0,0,0,0,0,0,0,0,0,0,0,2015
2,20452,YX,YX,Republic Airlines,2,12748014,0,0,0,0,12748014,12748014,0,12748014,22851411,0,0,0,0,22851411,22851411,0,22851411,2015
2,20046,ZW,ZW,Air Wisconsin Airlines Corp,2,5878909,0,0,0,0,5878909,5878909,0,5878909,11422884,0,0,0,0,11422884,11422884,0,11422884,2015
2,19393,WN,WN,Southwest Airlines Co.,3,127521180,0,0,772166,772166,128293346,127748054,772166,128520220,246070047,0,0,1564236,1564236,247634283,246517847,1564236,248082083,2015
3,21236,0JQ,0JQ,Vision Airlines,1,0,0,0,0,0,0,0,149766,149766,0,0,0,0,0,0,0,384513,384513,2015
3,21352,0WQ,0WQ,Avjet Corporation,1,0,0,0,0,0,0,169629,18672,188301,0,0,0,0,0,0,547902,60497,608399,2015
3,20397,OH,16,PSA Airlines Inc.,2,0,0,0,0,0,0,0,0,0,0,0,0,0,0,0,0,0,0,2015
3,21645,23Q,23Q,Sky King Inc.,1,0,0,0,0,0,0,0,0,0,0,0,0,0,0,0,0,0,0,2015
3,20408,5V,5V,Tatonduk Outfitters Limited d/b/a Everts Air Alaska and Everts Air Cargo,1,294110,0,0,0,0,294110,388170,0,388170,717505,0,0,0,0,717505,946972,0,946972,2015
3,19917,5X,5X,United Parcel Service,3,31206000,9787000,16062000,2813000,28662000,59868000,31206000,28662000,59868000,55606000,15566000,28368000,5305000,49239000,104845000,55606000,49239000,104845000,2015
3,20007,5Y,5Y,Atlas Air Inc.,3,0,0,0,0,0,0,7203521,25191956,32395477,0,0,0,0,0,0,15827628,57030840,72858468,2015
3,19874,8C,8C,Air Transport International,2,0,0,0,0,0,0,10618,724327,734945,0,0,0,0,0,0,29465,2241612,2271077,2015
3,20363,9E,9E,Endeavor Air Inc.,2,0,0,0,0,0,0,0,0,0,0,0,0,0,0,0,0,0,0,2015
3,20190,9S,9S,Southern Air Inc.,2,0,2793494,2496274,0,5289768,5289768,0,5289768,5289768,0,10112448,9036512,0,19148960,19148960,0,19148960,19148960,2015
3,19805,AA,AA,American Airlines Inc.,3,115965981,27324209,17475077,45601919,90401205,206367186,116510802,90615350,207126152,211610708,42846849,28904337,85351588,157102774,368713482,212526114,157507057,370033171,2015
3,20453,ABX,ABX,ABX Air Inc,2,37579,0,0,0,0,37579,37579,0,37579,101799,0,0,0,0,101799,101799,0,101799,2015
3,19930,AS,AS,Alaska Airlines Inc.,3,36221515,0,0,1250261,1250261,37471776,36268702,1250261,37518963,72877534,0,0,2419225,2419225,75296759,72962194,2419225,75381419,2015
3,20409,B6,B6,JetBlue Airways,3,48620309,0,0,9444194,9444194,58064503,48620309,9444194,58064503,102771307,0,0,19962691,19962691,122733998,102771307,19962691,122733998,2015
3,21167,CP,CP,Compass Airlines,2,0,0,0,0,0,0,0,0,0,0,0,0,0,0,0,0,0,0,2015
3,19790,DL,DL,Delta Air Lines Inc.,3,149445127,56808818,42639870,31588684,131037372,280482499,150807913,131902531,282710444,394715231,150043741,112620643,83432192,346096576,740811807,398876443,348381638,747258081,2015
3,20366,EV,EV,ExpressJet Airlines Inc.,3,86925,0,0,0,0,86925,86925,0,86925,276920,0,0,0,0,276920,276920,0,276920,2015
3,20436,F9,F9,Frontier Airlines Inc.,3,12957801,0,0,2347330,2347330,15305131,13012731,2352242,15364973,25635507,0,0,4959037,4959037,30594544,25754714,4968657,30723371,2015
3,20203,FCQ,FCQ,Falcon Air Express,1,0,0,0,0,0,0,169651,0,169651,0,0,0,0,0,0,623800,0,623800,2015
3,20107,FX,FX,Federal Express Corporation,3,55709458,12295016,20590997,2191869,35077882,90787340,57380073,35960538,93340611,110410000,23803000,38912000,4850000,67565000,177975000,113550000,69793000,183343000,2015
3,20368,G4,G4,Allegiant Air,2,14238889,0,0,0,0,14238889,14700823,0,14700823,28643710,0,0,0,0,28643710,29624417,0,29624417,2015
3,20500,G7,G7,GoJet Airlines LLC d/b/a United Express,2,0,0,0,0,0,0,0,0,0,0,0,0,0,0,0,0,0,0,2015
3,20166,GFQ,GFQ,Gulf And Caribbean Cargo,1,0,0,0,0,0,0,191505,108386,299891,0,0,0,0,0,0,462555,262968,725523,2015
3,20402,GL,GL,Miami Air International,2,0,0,0,0,0,0,437943,262192,700135,0,0,0,0,0,0,1157001,692685,1849686,2015
3,19690,HA,HA,Hawaiian Airlines Inc.,3,13423454,0,5848191,0,5848191,19271645,13498457,5852053,19350510,25212804,0,11392851,0,11392851,36605655,25358483,11400591,36759074,2015
3,20310,WL,K8,"Caribbean Sun Airlines, Inc. d/b/a World Atlantic Airlines",1,0,0,0,0,0,0,13552,248925,262477,0,0,0,0,0,0,25436,467205,492641,2015
3,20370,KAQ,KAQ,Kalitta Air LLC,2,0,0,0,0,0,0,2005482,3764006,5769488,0,0,0,0,0,0,3749921,7434929,11184850,2015
3,21629,KD,KD,Western Global,1,0,0,0,0,0,0,281778,296650,578428,0,0,0,0,0,0,0,0,0,2015
3,21634,KH,KH,Aloha Air Cargo,1,419295,0,0,0,0,419295,419295,0,419295,754295,0,0,0,0,754295,754295,0,754295,2015
3,20372,KLQ,KLQ,Kalitta Charters II,1,0,0,0,0,0,0,157011,68912,225923,0,0,0,0,0,0,364257,166328,530585,2015
3,20169,L2,L2,Lynden Air Cargo Airlines,1,80568,0,0,0,0,80568,116240,0,116240,193460,0,0,0,0,193460,296805,0,296805,2015
3,20151,M6,M6,Amerijet International,2,0,0,0,1605962,1605962,1605962,270806,1660843,1931649,0,0,0,3143979,3143979,3143979,530155,3251419,3781574,2015
3,20398,MQ,MQ,Envoy Air,3,0,0,0,0,0,0,0,0,0,0,0,0,0,0,0,0,0,0,2015
3,20405,N8,MRQ,"National Air Cargo Group, Inc. d/b/a Murray Air",1,0,0,0,0,0,0,0,596769,596769,0,0,0,0,0,0,0,1373110,1373110,2015
3,20108,NC,NC,Northern Air Cargo Inc.,1,361138,0,0,0,0,361138,508582,25566,534148,720886,0,0,0,0,720886,1017800,50810,1068610,2015
3,20416,NK,NK,Spirit Air Lines,3,18244234,0,0,1848535,1848535,20092769,18244234,1848535,20092769,41123649,0,0,4166713,4166713,45290362,41123649,4166713,45290362,2015
3,20304,OO,OO,SkyWest Airlines Inc.,3,4113954,0,0,0,0,4113954,4113954,0,4113954,9230330,0,0,0,0,9230330,9230330,0,9230330,2015
3,20177,PFQ,PFQ,Asia Pacific,1,0,0,0,0,0,0,0,329495,329495,0,0,0,0,0,0,0,847818,847818,2015
3,20100,PO,PO,Polar Air Cargo Airways,3,2892042,692212,11068534,0,11760746,14652788,2892042,11760746,14652788,5314845,1544276,19997593,0,21541869,26856714,5314845,21541869,26856714,2015
3,20149,PRQ,PRQ,Florida West Airlines Inc.,1,0,0,0,0,0,0,0,0,0,0,0,0,0,0,0,0,0,0,2015
3,19687,QX,QX,Horizon Air,2,0,0,0,0,0,0,0,0,0,0,0,0,0,0,0,0,0,0,2015
3,20448,S5,S5,Shuttle America Corp.,2,6434762,0,0,0,0,6434762,6434762,0,6434762,11218963,0,0,0,0,11218963,11218963,0,11218963,2015
3,20422,SY,SY,Sun Country Airlines d/b/a MN Airlines,2,2981517,0,0,1526442,1526442,4507959,3903840,1974099,5877939,5917289,0,0,3098944,3098944,9016233,7760416,4063064,11823480,2015
3,20447,U7,U7,USA Jet Airlines Inc.,2,0,0,0,0,0,0,463761,22690,486451,0,0,0,0,0,0,867233,60129,927362,2015
3,19977,UA,UA,United Air Lines Inc.,3,121171647,56960008,57132165,31580972,145673145,266844792,122086218,146103212,268189430,218163246,105477550,106859173,59862105,272198828,490362074,221282227,273016745,494298972,2015
3,20355,US,US,US Airways Inc.,3,74604232,12239494,0,7847430,20086924,94691156,75002959,20128616,95131575,129787946,22181416,0,14487387,36668803,166456749,130473559,36746749,167220308,2015
3,21171,VX,VX,Virgin America,3,13095555,0,0,161825,161825,13257380,13241708,161825,13403533,23051006,0,0,310294,310294,23361300,23330354,310294,23640648,2015
3,20308,WE,WE,Centurion Cargo Inc.,2,0,0,0,0,0,0,0,827829,827829,0,0,0,0,0,0,0,1433363,1433363,2015
3,20195,WI,WI,Sky Lease Cargo,1,0,0,0,0,0,0,0,0,0,0,0,0,0,0,0,0,0,0,2015
3,20287,WP,WP,Island Air Hawaii,1,155602,0,0,0,0,155602,155602,0,155602,305469,0,0,0,0,305469,305469,0,305469,2015
3,20377,X9,X9,Omni Air Express,2,0,0,0,0,0,0,345088,1681195,2026283,0,0,0,0,0,0,695256,5919966,6615222,2015
3,20207,XP,XP,XTRA Airways,1,0,0,0,0,0,0,143093,239443,382536,0,0,0,0,0,0,470775,787767,1258542,2015
3,20378,YV,YV,Mesa Airlines Inc.,2,0,0,0,0,0,0,0,0,0,0,0,0,0,0,0,0,0,0,2015
3,20452,YX,YX,Republic Airlines,2,14890099,0,0,0,0,14890099,14890099,0,14890099,26937693,0,0,0,0,26937693,26937693,0,26937693,2015
3,20046,ZW,ZW,Air Wisconsin Airlines Corp,2,6624096,0,0,0,0,6624096,6624096,0,6624096,12971802,0,0,0,0,12971802,12971802,0,12971802,2015
3,19393,WN,WN,Southwest Airlines Co.,3,161798302,0,0,993128,993128,162791430,162120451,993128,163113579,303973670,0,0,2069882,2069882,306043552,304548604,2069882,306618486,2015
4,21236,0JQ,0JQ,Vision Airlines,1,0,0,0,0,0,0,0,41992,41992,0,0,0,0,0,0,0,97169,97169,2015
4,21352,0WQ,0WQ,Avjet Corporation,1,0,0,0,0,0,0,194166,71112,265278,0,0,0,0,0,0,634923,164269,799192,2015
4,20397,OH,16,PSA Airlines Inc.,2,0,0,0,0,0,0,0,0,0,0,0,0,0,0,0,0,0,0,2015
4,21645,23Q,23Q,Sky King Inc.,1,0,0,0,0,0,0,0,0,0,0,0,0,0,0,0,0,0,0,2015
4,20408,5V,5V,Tatonduk Outfitters Limited d/b/a Everts Air Alaska and Everts Air Cargo,1,266693,0,0,0,0,266693,417446,0,417446,673444,0,0,0,0,673444,1054120,0,1054120,2015
4,19917,5X,5X,United Parcel Service,3,31799000,9786000,16052000,3035000,28873000,60672000,31799000,28873000,60672000,54787000,15093000,27449000,5570000,48112000,102899000,54787000,48112000,102899000,2015
4,20007,5Y,5Y,Atlas Air Inc.,3,0,0,0,0,0,0,5636955,25931307,31568262,0,0,0,0,0,0,12923185,59999563,72922748,2015
4,19874,8C,8C,Air Transport International,2,0,0,0,0,0,0,0,852865,852865,0,0,0,0,0,0,0,2575768,2575768,2015
4,20363,9E,9E,Endeavor Air Inc.,2,0,0,0,0,0,0,0,0,0,0,0,0,0,0,0,0,0,0,2015
4,20190,9S,9S,Southern Air Inc.,2,0,2310633,2570409,0,4881042,4881042,0,4881042,4881042,0,8364491,9304881,0,17669372,17669372,0,17669372,17669372,2015
4,19805,AA,AA,American Airlines Inc.,3,115848748,29250359,16938637,40872430,87061426,202910174,116256083,87249474,203505557,205606342,43581340,27835201,74718819,146135360,351741702,206306881,146495884,352802765,2015
4,20453,ABX,ABX,ABX Air Inc,2,52597,0,0,0,0,52597,52597,0,52597,139151,0,0,0,0,139151,139151,0,139151,2015
4,19930,AS,AS,Alaska Airlines Inc.,3,34664669,0,0,1139400,1139400,35804069,34743425,1139400,35882825,68176111,0,0,2180580,2180580,70356691,68313621,2180580,70494201,2015
4,20409,B6,B6,JetBlue Airways,3,47056338,0,0,10307057,10307057,57363395,47056338,10307057,57363395,94860351,0,0,20777882,20777882,115638233,94860351,20777882,115638233,2015
4,21167,CP,CP,Compass Airlines,2,0,0,0,0,0,0,0,0,0,0,0,0,0,0,0,0,0,0,2015
4,19790,DL,DL,Delta Air Lines Inc.,3,142983598,64779633,39931139,27375576,132086348,275069946,144125088,132993532,277118620,354771164,160731343,99077214,67924328,327732885,682504049,358110283,329983792,688094075,2015
4,20366,EV,EV,ExpressJet Airlines Inc.,3,103937,0,0,0,0,103937,103937,0,103937,279676,0,0,0,0,279676,279676,0,279676,2015
4,20436,F9,F9,Frontier Airlines Inc.,3,13304937,0,0,1865257,1865257,15170194,13356003,1871011,15227014,25004449,0,0,3894095,3894095,28898544,25109153,3906057,29015210,2015
4,20107,FX,FX,Federal Express Corporation,3,57726705,11989845,19476183,2126012,33592040,91318745,59115713,34181538,93297251,112334000,22843000,35826000,4599000,63268000,175602000,114845000,64487000,179332000,2015
4,20368,G4,G4,Allegiant Air,2,11816051,0,0,0,0,11816051,12232341,0,12232341,22928136,0,0,0,0,22928136,23788422,0,23788422,2015
4,20500,G7,G7,GoJet Airlines LLC d/b/a United Express,2,0,0,0,0,0,0,0,0,0,0,0,0,0,0,0,0,0,0,2015
4,20166,GFQ,GFQ,Gulf And Caribbean Cargo,1,0,0,0,0,0,0,99022,63660,162682,0,0,0,0,0,0,219637,152968,372605,2015
4,20402,GL,GL,Miami Air International,2,0,0,0,0,0,0,356831,267096,623927,0,0,0,0,0,0,875378,655242,1530620,2015
4,19690,HA,HA,Hawaiian Airlines Inc.,3,12605374,0,5603024,0,5603024,18208398,12656521,5624974,18281495,21795738,0,9839607,0,9839607,31635345,21885451,9877802,31763253,2015
4,20310,WL,K8,"Caribbean Sun Airlines, Inc. d/b/a World Atlantic Airlines",1,0,0,0,0,0,0,18597,221045,239642,0,0,0,0,0,0,32123,381821,413944,2015
4,20370,KAQ,KAQ,Kalitta Air LLC,2,0,0,0,0,0,0,846092,2434014,3280106,0,0,0,0,0,0,1499538,4872787,6372325,2015
4,21629,KD,KD,Western Global,1,0,0,0,0,0,0,0,0,0,0,0,0,0,0,0,0,0,0,2015
4,21634,KH,KH,Aloha Air Cargo,1,432138,0,0,0,0,432138,432138,0,432138,813287,0,0,0,0,813287,813287,0,813287,2015
4,20372,KLQ,KLQ,Kalitta Charters II,1,0,0,0,0,0,0,72114,44824,116938,0,0,0,0,0,0,171911,103005,274916,2015
4,20169,L2,L2,Lynden Air Cargo Airlines,1,68203,0,0,0,0,68203,195715,0,195715,161504,0,0,0,0,161504,436017,0,436017,2015
4,20151,M6,M6,Amerijet International,2,0,0,0,1458537,1458537,1458537,313090,1504567,1817657,0,0,0,2812842,2812842,2812842,603805,2901613,3505418,2015
4,20398,MQ,MQ,Envoy Air,3,0,0,0,0,0,0,0,0,0,0,0,0,0,0,0,0,0,0,2015
4,20405,N8,MRQ,"National Air Cargo Group, Inc. d/b/a Murray Air",1,0,0,0,0,0,0,100,1604879,1604979,0,0,0,0,0,0,0,4432422,4432422,2015
4,20108,NC,NC,Northern Air Cargo Inc.,1,352499,0,0,0,0,352499,460887,0,460887,712124,0,0,0,0,712124,924252,0,924252,2015
4,20416,NK,NK,Spirit Air Lines,3,18481670,0,0,1850200,1850200,20331870,18481670,1850200,20331870,33173626,0,0,3321012,3321012,36494638,33173626,3321012,36494638,2015
4,20304,OO,OO,SkyWest Airlines Inc.,3,4221329,0,0,0,0,4221329,4221329,0,4221329,9037596,0,0,0,0,9037596,9037596,0,9037596,2015
4,20177,PFQ,PFQ,Asia Pacific,1,0,0,0,0,0,0,0,249109,249109,0,0,0,0,0,0,0,621392,621392,2015
4,20100,PO,PO,Polar Air Cargo Airways,3,2658689,624524,11047164,0,11671688,14330377,2658689,11671688,14330377,4804429,1411294,19080338,0,20491632,25296061,4804429,20491632,25296061,2015
4,20149,PRQ,PRQ,Florida West Airlines Inc.,1,0,0,0,0,0,0,0,0,0,0,0,0,0,0,0,0,0,0,2015
4,19687,QX,QX,Horizon Air,2,0,0,0,0,0,0,0,0,0,0,0,0,0,0,0,0,0,0,2015
4,20448,S5,S5,Shuttle America Corp.,2,6162438,0,0,0,0,6162438,6162438,0,6162438,10600900,0,0,0,0,10600900,10600900,0,10600900,2015
4,20422,SY,SY,Sun Country Airlines d/b/a MN Airlines,2,2926570,0,0,824118,824118,3750688,3378896,1039967,4418863,5503636,0,0,1586299,1586299,7089935,6542669,1963413,8506082,2015
4,20447,U7,U7,USA Jet Airlines Inc.,2,0,0,0,0,0,0,296005,4696,300701,0,0,0,0,0,0,543675,12371,556046,2015
4,19977,UA,UA,United Air Lines Inc.,3,115949988,58700256,54823774,30178144,143702174,259652162,116937794,144231471,261169265,200101228,103104455,98284708,54366927,255756090,455857318,202381053,256704621,459085674,2015
4,20355,US,US,US Airways Inc.,3,70149797,16720750,0,7539512,24260262,94410059,70470266,24297538,94767804,118726922,28993831,0,13608899,42602730,161329652,119263796,42668995,161932791,2015
4,21171,VX,VX,Virgin America,3,13539129,0,0,206560,206560,13745689,13601404,206560,13807964,23272326,0,0,390582,390582,23662908,23380697,390582,23771279,2015
4,20308,WE,WE,Centurion Cargo Inc.,2,0,0,0,0,0,0,0,1108458,1108458,0,0,0,0,0,0,0,1792151,1792151,2015
4,20195,WI,WI,Sky Lease Cargo,1,0,0,0,0,0,0,0,0,0,0,0,0,0,0,0,0,0,0,2015
4,20287,WP,WP,Island Air Hawaii,1,139183,0,0,0,0,139183,139183,0,139183,260896,0,0,0,0,260896,260896,0,260896,2015
4,20377,X9,X9,Omni Air Express,2,0,0,0,0,0,0,353962,2537018,2890980,0,0,0,0,0,0,798971,8695691,9494662,2015
4,20207,XP,XP,XTRA Airways,1,0,0,0,0,0,0,36870,234634,271504,0,0,0,0,0,0,85170,542005,627175,2015
4,20378,YV,YV,Mesa Airlines Inc.,2,0,0,0,0,0,0,0,0,0,0,0,0,0,0,0,0,0,0,2015
4,20452,YX,YX,Republic Airlines,2,14753451,0,0,0,0,14753451,14753451,0,14753451,26091310,0,0,0,0,26091310,26091310,0,26091310,2015
4,20046,ZW,ZW,Air Wisconsin Airlines Corp,2,6694082,0,0,0,0,6694082,6694082,0,6694082,12946971,0,0,0,0,12946971,12946971,0,12946971,2015
4,19393,WN,WN,Southwest Airlines Co.,3,159318951,0,0,986370,986370,160305321,159535373,986370,160521743,292154670,0,0,1992145,1992145,294146815,292675472,1992145,294667617,2015
5,21236,0JQ,0JQ,Vision Airlines,1,0,0,0,0,0,0,117980,0,117980,0,0,0,0,0,0,296130,0,296130,2015
5,21352,0WQ,0WQ,Avjet Corporation,1,0,0,0,0,0,0,151657,32537,184194,0,0,0,0,0,0,550515,78739,629254,2015
5,20397,OH,16,PSA Airlines Inc.,2,0,0,0,0,0,0,0,0,0,0,0,0,0,0,0,0,0,0,2015
5,21645,23Q,23Q,Sky King Inc.,1,0,0,0,0,0,0,0,0,0,0,0,0,0,0,0,0,0,0,2015
5,20408,5V,5V,Tatonduk Outfitters Limited d/b/a Everts Air Alaska and Everts Air Cargo,1,298485,0,0,0,0,298485,441576,0,441576,861742,0,0,0,0,861742,1274853,0,1274853,2015
5,19917,5X,5X,United Parcel Service,3,29971000,9659000,15783000,3001000,28443000,58414000,29971000,28443000,58414000,58439000,15949000,28459000,6064000,50472000,108911000,58439000,50472000,108911000,2015
5,20007,5Y,5Y,Atlas Air Inc.,3,0,0,0,0,0,0,6214653,25029230,31243883,0,0,0,0,0,0,15016444,60040908,75057352,2015
5,19874,8C,8C,Air Transport International,2,0,0,0,0,0,0,2204,847130,849334,0,0,0,0,0,0,4995,2529264,2534259,2015
5,20363,9E,9E,Endeavor Air Inc.,2,0,0,0,0,0,0,0,0,0,0,0,0,0,0,0,0,0,0,2015
5,20190,9S,9S,Southern Air Inc.,2,0,2617348,2500447,0,5117795,5117795,0,5117795,5117795,0,9474799,9051618,0,18526417,18526417,0,18526417,18526417,2015
5,19805,AA,AA,American Airlines Inc.,3,114992833,34410258,19595132,42742805,96748195,211741028,115441594,96974607,212416201,224621411,55827284,31537134,83997118,171361536,395982947,225449744,171791894,397241638,2015
5,20453,ABX,ABX,ABX Air Inc,2,43151,0,0,0,0,43151,43151,0,43151,148008,0,0,0,0,148008,148008,0,148008,2015
5,19930,AS,AS,Alaska Airlines Inc.,3,35559074,0,0,786264,786264,36345338,35623037,786264,36409301,80464600,0,0,1671969,1671969,82136569,80595763,1671969,82267732,2015
5,20409,B6,B6,JetBlue Airways,3,47589931,0,0,9668534,9668534,57258465,47589931,9668534,57258465,105762046,0,0,21486981,21486981,127249027,105762046,21486981,127249027,2015
5,21167,CP,CP,Compass Airlines,2,0,0,0,0,0,0,0,0,0,0,0,0,0,0,0,0,0,0,2015
5,19790,DL,DL,Delta Air Lines Inc.,3,149125898,73970627,42526050,26358576,142855253,291981151,149943988,142973544,292917532,369760192,183411423,105444063,65356536,354212022,723972214,372431466,354505327,726936793,2015
5,20366,EV,EV,ExpressJet Airlines Inc.,3,92303,0,0,0,0,92303,92303,0,92303,326977,0,0,0,0,326977,326977,0,326977,2015
5,20436,F9,F9,Frontier Airlines Inc.,3,15592874,0,0,1161558,1161558,16754432,15656246,1165299,16821545,32280080,0,0,2607927,2607927,34888007,32427206,2616269,35043475,2015
5,20107,FX,FX,Federal Express Corporation,3,55633188,11520280,19626737,2143030,33290047,88923235,56673551,33947955,90621506,121100000,23466000,38443000,4907000,66816000,187916000,123279000,68490000,191769000,2015
5,20368,G4,G4,Allegiant Air,2,11320758,0,0,0,0,11320758,11747610,0,11747610,25084035,0,0,0,0,25084035,26089990,0,26089990,2015
5,20500,G7,G7,GoJet Airlines LLC d/b/a United Express,2,0,0,0,0,0,0,0,0,0,0,0,0,0,0,0,0,0,0,2015
5,20166,GFQ,GFQ,Gulf And Caribbean Cargo,1,0,0,0,0,0,0,170451,122937,293388,0,0,0,0,0,0,418879,316294,735173,2015
5,20402,GL,GL,Miami Air International,2,0,0,0,0,0,0,274165,173782,447947,0,0,0,0,0,0,720766,456862,1177628,2015
5,19690,HA,HA,Hawaiian Airlines Inc.,3,13675840,0,5836414,0,5836414,19512254,13810410,5871335,19681745,26725029,0,10777325,0,10777325,37502354,26984166,10853753,37837919,2015
5,20310,WL,K8,"Caribbean Sun Airlines, Inc. d/b/a World Atlantic Airlines",1,0,0,0,0,0,0,22253,256897,279150,0,0,0,0,0,0,39962,461338,501300,2015
5,20370,KAQ,KAQ,Kalitta Air LLC,2,0,0,0,0,0,0,783751,3364728,4148479,0,0,0,0,0,0,1542677,6694119,8236796,2015
5,21629,KD,KD,Western Global,1,0,0,0,0,0,0,26488,2845,29333,0,0,0,0,0,0,26488,2845,29333,2015
5,21634,KH,KH,Aloha Air Cargo,1,414753,0,0,0,0,414753,414753,0,414753,802122,0,0,0,0,802122,802122,0,802122,2015
5,20372,KLQ,KLQ,Kalitta Charters II,1,0,0,0,0,0,0,153273,50048,203321,0,0,0,0,0,0,393885,136765,530650,2015
5,20169,L2,L2,Lynden Air Cargo Airlines,1,63533,0,0,0,0,63533,199054,0,199054,187897,0,0,0,0,187897,602639,0,602639,2015
5,20151,M6,M6,Amerijet International,2,0,0,0,1412525,1412525,1412525,470245,1620555,2090800,0,0,0,2988943,2988943,2988943,995052,3429140,4424192,2015
5,20398,MQ,MQ,Envoy Air,3,0,0,0,0,0,0,0,0,0,0,0,0,0,0,0,0,0,0,2015
5,20405,N8,MRQ,"National Air Cargo Group, Inc. d/b/a Murray Air",1,0,0,0,0,0,0,0,391218,391218,0,0,0,0,0,0,0,1008271,1008271,2015
5,20108,NC,NC,Northern Air Cargo Inc.,1,432761,0,0,0,0,432761,549497,14368,563865,1012174,0,0,0,0,1012174,1289831,35179,1325010,2015
5,20416,NK,NK,Spirit Air Lines,3,19854871,0,0,1963669,1963669,21818540,19854871,1963669,21818540,43615268,0,0,4313598,4313598,47928866,43615268,4313598,47928866,2015
5,20304,OO,OO,SkyWest Airlines Inc.,3,4399711,0,0,0,0,4399711,4399711,0,4399711,10860706,0,0,0,0,10860706,10860706,0,10860706,2015
5,20177,PFQ,PFQ,Asia Pacific,1,0,0,0,0,0,0,0,297982,297982,0,0,0,0,0,0,0,745308,745308,2015
5,20100,PO,PO,Polar Air Cargo Airways,3,2936648,694746,11350839,0,12045585,14982233,2936648,12045585,14982233,5783793,1623327,20781421,0,22404748,28188541,5783793,22404748,28188541,2015
5,20149,PRQ,PRQ,Florida West Airlines Inc.,1,0,0,0,0,0,0,0,0,0,0,0,0,0,0,0,0,0,0,2015
5,19687,QX,QX,Horizon Air,2,0,0,0,0,0,0,0,0,0,0,0,0,0,0,0,0,0,0,2015
5,20448,S5,S5,Shuttle America Corp.,2,6339654,0,0,0,0,6339654,6339654,0,6339654,12140525,0,0,0,0,12140525,12140525,0,12140525,2015
5,20422,SY,SY,Sun Country Airlines d/b/a MN Airlines,2,3114390,0,0,290565,290565,3404955,3537580,547875,4085455,6603440,0,0,643947,643947,7247387,7616617,1147590,8764207,2015
5,20447,U7,U7,USA Jet Airlines Inc.,2,0,0,0,0,0,0,407142,12370,419512,0,0,0,0,0,0,823652,33486,857138,2015
5,19977,UA,UA,United Air Lines Inc.,3,126461101,69534295,57781148,25765565,153081008,279542109,127377097,153664511,281041608,244028408,130613930,111729156,50282062,292625148,536653556,247357393,293763923,541121316,2015
5,20355,US,US,US Airways Inc.,3,73667392,21792754,0,6928614,28721368,102388760,73993495,28814189,102807684,135010231,39839995,0,13408112,53248107,188258338,135562558,53407576,188970134,2015
5,21171,VX,VX,Virgin America,3,14143615,0,0,208833,208833,14352448,14202431,208833,14411264,27565315,0,0,439482,439482,28004797,27684378,439482,28123860,2015
5,20308,WE,WE,Centurion Cargo Inc.,2,0,0,0,0,0,0,0,884689,884689,0,0,0,0,0,0,0,1778942,1778942,2015
5,20195,WI,WI,Sky Lease Cargo,1,0,0,0,0,0,0,0,0,0,0,0,0,0,0,0,0,0,0,2015
5,20287,WP,WP,Island Air Hawaii,1,153319,0,0,0,0,153319,153319,0,153319,316247,0,0,0,0,316247,316247,0,316247,2015
5,20377,X9,X9,Omni Air Express,2,0,0,0,0,0,0,355955,2337635,2693590,0,0,0,0,0,0,805252,8006748,8812000,2015
5,20207,XP,XP,XTRA Airways,1,0,0,0,0,0,0,59357,259350,318707,0,0,0,0,0,0,154922,676904,831826,2015
5,20378,YV,YV,Mesa Airlines Inc.,2,0,0,0,0,0,0,0,0,0,0,0,0,0,0,0,0,0,0,2015
5,20452,YX,YX,Republic Airlines,2,14720553,0,0,0,0,14720553,14720553,0,14720553,28082523,0,0,0,0,28082523,28082523,0,28082523,2015
5,20046,ZW,ZW,Air Wisconsin Airlines Corp,2,6847837,0,0,0,0,6847837,6847837,0,6847837,13689513,0,0,0,0,13689513,13689513,0,13689513,2015
5,19393,WN,WN,Southwest Airlines Co.,3,162319826,0,0,1099019,1099019,163418845,162647283,1099019,163746302,326648518,0,0,2461691,2461691,329110209,327303482,2461691,329765173,2015
6,21236,0JQ,0JQ,Vision Airlines,1,0,0,0,0,0,0,74738,0,74738,0,0,0,0,0,0,238538,0,238538,2015
6,21352,0WQ,0WQ,Avjet Corporation,1,0,0,0,0,0,0,151487,34284,185771,0,0,0,0,0,0,524145,80911,605056,2015
6,20397,OH,16,PSA Airlines Inc.,2,0,0,0,0,0,0,0,0,0,0,0,0,0,0,0,0,0,0,2015
6,21645,23Q,23Q,Sky King Inc.,1,0,0,0,0,0,0,0,0,0,0,0,0,0,0,0,0,0,0,2015
9,20190,9S,9S,Southern Air Inc.,2,0,2685893,2537535,0,5223428,5223428,0,5223428,5223428,0,9722933,9185877,0,18908810,18908810,0,18908810,18908810,2015
6,20408,5V,5V,Tatonduk Outfitters Limited d/b/a Everts Air Alaska and Everts Air Cargo,1,321343,0,0,0,0,321343,441205,0,441205,914939,0,0,0,0,914939,1256215,0,1256215,2015
6,19917,5X,5X,United Parcel Service,3,31429000,9715000,15971000,2800000,28486000,59915000,31429000,28486000,59915000,58337000,16101000,29436000,5497000,51034000,109371000,58337000,51034000,109371000,2015
6,20007,5Y,5Y,Atlas Air Inc.,3,0,0,0,0,0,0,5593432,24422105,30015537,0,0,0,0,0,0,13839343,60975010,74814353,2015
6,19874,8C,8C,Air Transport International,2,0,0,0,0,0,0,1584,704247,705831,0,0,0,0,0,0,4440,2171792,2176232,2015
6,20363,9E,9E,Endeavor Air Inc.,2,0,0,0,0,0,0,0,0,0,0,0,0,0,0,0,0,0,0,2015
6,20190,9S,9S,Southern Air Inc.,2,0,2434209,2645648,0,5079857,5079857,0,5079857,5079857,0,8811836,9577245,0,18389081,18389081,0,18389081,18389081,2015
6,19805,AA,AA,American Airlines Inc.,3,116311462,36233963,18290488,42870018,97394469,213705931,116638773,97470183,214108956,226089482,59267417,29409354,83685892,172362663,398452145,226684694,172527967,399212661,2015
6,20453,ABX,ABX,ABX Air Inc,2,163837,0,0,0,0,163837,163837,0,163837,437255,0,0,0,0,437255,437255,0,437255,2015
6,19930,AS,AS,Alaska Airlines Inc.,3,36690370,0,0,626225,626225,37316595,36782134,626225,37408359,80228188,0,0,1298675,1298675,81526863,80408619,1298675,81707294,2015
6,20409,B6,B6,JetBlue Airways,3,48806973,0,0,10574792,10574792,59381765,48806973,10574792,59381765,105581856,0,0,22875955,22875955,128457811,105581856,22875955,128457811,2015
6,21167,CP,CP,Compass Airlines,2,0,0,0,0,0,0,0,0,0,0,0,0,0,0,0,0,0,0,2015
6,19790,DL,DL,Delta Air Lines Inc.,3,156461107,82909508,42402910,26883375,152195793,308656900,157173139,152195793,309368932,385248229,204144925,104407072,66193911,374745908,759994137,387702516,374745908,762448424,2015
6,20366,EV,EV,ExpressJet Airlines Inc.,3,96355,0,0,0,0,96355,96355,0,96355,326425,0,0,0,0,326425,326425,0,326425,2015
6,20436,F9,F9,Frontier Airlines Inc.,3,15340072,0,0,1331118,1331118,16671190,15388161,1339351,16727512,28697225,0,0,2642423,2642423,31339648,28792350,2657571,31449921,2015
6,20107,FX,FX,Federal Express Corporation,3,54675009,11815500,18850681,2129408,32795589,87470598,55645254,33180630,88825884,108577000,23331000,37444000,4735000,65510000,174087000,110483000,66370000,176853000,2015
6,20368,G4,G4,Allegiant Air,2,13802690,0,0,0,0,13802690,14380696,0,14380696,28939716,0,0,0,0,28939716,30189211,0,30189211,2015
6,20500,G7,G7,GoJet Airlines LLC d/b/a United Express,2,0,0,0,0,0,0,0,0,0,0,0,0,0,0,0,0,0,0,2015
6,20166,GFQ,GFQ,Gulf And Caribbean Cargo,1,0,0,0,0,0,0,207698,179021,386719,0,0,0,0,0,0,495862,447735,943597,2015
6,20402,GL,GL,Miami Air International,2,0,0,0,0,0,0,424264,118890,543154,0,0,0,0,0,0,1079073,302385,1381458,2015
6,19690,HA,HA,Hawaiian Airlines Inc.,3,14375735,0,5629201,0,5629201,20004936,14405623,5629201,20034824,27362959,0,10849193,0,10849193,38212152,27418921,10849193,38268114,2015
6,20310,WL,K8,"Caribbean Sun Airlines, Inc. d/b/a World Atlantic Airlines",1,0,0,0,0,0,0,50732,398299,449031,0,0,0,0,0,0,115121,903823,1018944,2015
6,20370,KAQ,KAQ,Kalitta Air LLC,2,0,0,0,0,0,0,818081,2857379,3675460,0,0,0,0,0,0,1775687,6008116,7783803,2015
6,21629,KD,KD,Western Global,1,0,0,0,0,0,0,25547,0,25547,0,0,0,0,0,0,25547,0,25547,2015
6,21634,KH,KH,Aloha Air Cargo,1,448352,0,0,0,0,448352,448352,0,448352,845554,0,0,0,0,845554,845554,0,845554,2015
6,20372,KLQ,KLQ,Kalitta Charters II,1,0,0,0,0,0,0,117525,136660,254185,0,0,0,0,0,0,284186,355704,639890,2015
6,20169,L2,L2,Lynden Air Cargo Airlines,1,61073,0,0,0,0,61073,153039,0,153039,153779,0,0,0,0,153779,393288,0,393288,2015
6,20151,M6,M6,Amerijet International,2,0,0,0,1475430,1475430,1475430,471522,1806967,2278489,0,0,0,3000033,3000033,3000033,958759,3674157,4632916,2015
6,20398,MQ,MQ,Envoy Air,3,0,0,0,0,0,0,0,0,0,0,0,0,0,0,0,0,0,0,2015
6,20405,N8,MRQ,"National Air Cargo Group, Inc. d/b/a Murray Air",1,0,0,0,0,0,0,45584,294248,339832,0,0,0,0,0,0,121690,749665,871355,2015
6,20108,NC,NC,Northern Air Cargo Inc.,1,424135,0,0,0,0,424135,611149,41147,652296,899632,0,0,0,0,899632,1309252,96964,1406216,2015
6,20416,NK,NK,Spirit Air Lines,3,18621773,0,0,2301568,2301568,20923341,18621773,2301568,20923341,38350933,0,0,4740003,4740003,43090936,38350933,4740003,43090936,2015
6,20304,OO,OO,SkyWest Airlines Inc.,3,4386900,0,0,0,0,4386900,4386900,0,4386900,10364644,0,0,0,0,10364644,10364644,0,10364644,2015
6,20177,PFQ,PFQ,Asia Pacific,1,0,0,0,0,0,0,0,305329,305329,0,0,0,0,0,0,0,787334,787334,2015
6,20100,PO,PO,Polar Air Cargo Airways,3,3046196,652131,11460546,0,12112677,15158873,3046196,12178755,15224951,5840261,1524121,22141638,0,23665759,29506020,5840261,23665759,29506020,2015
6,20149,PRQ,PRQ,Florida West Airlines Inc.,1,0,0,0,0,0,0,0,0,0,0,0,0,0,0,0,0,0,0,2015
6,19687,QX,QX,Horizon Air,2,0,0,0,0,0,0,0,0,0,0,0,0,0,0,0,0,0,0,2015
6,20448,S5,S5,Shuttle America Corp.,2,6398211,0,0,0,0,6398211,6398211,0,6398211,11612385,0,0,0,0,11612385,11612385,0,11612385,2015
6,20422,SY,SY,Sun Country Airlines d/b/a MN Airlines,2,3300914,0,0,583419,583419,3884333,3772443,814770,4587213,6591051,0,0,1222679,1222679,7813730,7688503,1611616,9300119,2015
6,20447,U7,U7,USA Jet Airlines Inc.,2,0,0,0,0,0,0,437920,25481,463401,0,0,0,0,0,0,851483,69533,921016,2015
6,19977,UA,UA,United Air Lines Inc.,3,132665681,72638933,57056079,26783248,156478260,289143941,133768070,157028244,290796314,246782502,138237421,112340734,52286846,302865001,549647503,251303283,303953285,555256568,2015
6,20355,US,US,US Airways Inc.,3,77453596,22728612,0,7536561,30265173,107718769,77624601,30324847,107949448,145018551,42550156,0,14675328,57225484,202244035,145338087,57339908,202677995,2015
6,21171,VX,VX,Virgin America,3,14409837,0,0,207182,207182,14617019,14488660,207182,14695842,26726904,0,0,422931,422931,27149835,26879590,422931,27302521,2015
6,20308,WE,WE,Centurion Cargo Inc.,2,0,0,0,0,0,0,0,705238,705238,0,0,0,0,0,0,0,1489459,1489459,2015
6,20195,WI,WI,Sky Lease Cargo,1,0,0,0,0,0,0,0,0,0,0,0,0,0,0,0,0,0,0,2015
6,20287,WP,WP,Island Air Hawaii,1,80875,0,0,0,0,80875,80875,0,80875,166887,0,0,0,0,166887,166887,0,166887,2015
6,20377,X9,X9,Omni Air Express,2,0,0,0,0,0,0,481014,2301792,2782806,0,0,0,0,0,0,1050797,7852199,8902996,2015
6,20207,XP,XP,XTRA Airways,1,0,0,0,0,0,0,128976,380342,509318,0,0,0,0,0,0,336627,992693,1329320,2015
6,20378,YV,YV,Mesa Airlines Inc.,2,0,0,0,0,0,0,0,0,0,0,0,0,0,0,0,0,0,0,2015
6,20452,YX,YX,Republic Airlines,2,14666877,0,0,0,0,14666877,14666877,0,14666877,27550924,0,0,0,0,27550924,27550924,0,27550924,2015
6,20046,ZW,ZW,Air Wisconsin Airlines Corp,2,6925613,0,0,0,0,6925613,6925613,0,6925613,14090303,0,0,0,0,14090303,14090303,0,14090303,2015
6,19393,WN,WN,Southwest Airlines Co.,3,167617869,0,0,1288322,1288322,168906191,167929798,1288322,169218120,329546985,0,0,2840242,2840242,332387227,330197128,2840242,333037370,2015
7,21236,0JQ,0JQ,Vision Airlines,1,0,0,0,0,0,0,135175,0,135175,0,0,0,0,0,0,468104,0,468104,2015
7,21352,0WQ,0WQ,Avjet Corporation,1,0,0,0,0,0,0,136368,78239,214607,0,0,0,0,0,0,467742,188556,656298,2015
7,21645,23Q,23Q,Songbird Airways Inc.,1,0,0,0,0,0,0,0,0,0,0,0,0,0,0,0,0,0,0,2015
7,21652,27Q,27Q,"Jet Aviation Flight Services, Inc.",1,0,0,0,0,0,0,0,0,0,0,0,0,0,0,0,0,0,0,2015
7,20408,5V,5V,Tatonduk Outfitters Limited d/b/a Everts Air Alaska and Everts Air Cargo,1,378315,0,0,0,0,378315,452761,0,452761,956272,0,0,0,0,956272,1144450,0,1144450,2015
7,19917,5X,5X,United Parcel Service,3,33365000,10383000,16655000,2870000,29908000,63273000,33365000,29908000,63273000,57449000,16434000,29179000,5259000,50872000,108321000,57449000,50872000,108321000,2015
7,20007,5Y,5Y,Atlas Air Inc.,3,0,0,0,0,0,0,5281047,21947902,27228949,0,0,0,0,0,0,12092966,54415328,66508294,2015
7,19874,8C,8C,Air Transport International,2,0,0,0,0,0,0,2641,852578,855219,0,0,0,0,0,0,7403,2678586,2685989,2015
7,20363,9E,9E,Endeavor Air Inc.,2,0,0,0,0,0,0,0,0,0,0,0,0,0,0,0,0,0,0,2015
7,20190,9S,9S,Southern Air Inc.,2,0,2565967,2508240,0,5074207,5074207,0,5074207,5074207,0,9288800,9079829,0,18368629,18368629,0,18368629,18368629,2015
7,19805,AA,AA,American Airlines Inc.,3,201408139,61370025,18126016,53138098,132634139,334042278,201980963,132790311,334771274,352877112,100606817,27995476,97681408,226283701,579160813,353850177,226608905,580459082,2015
7,20453,ABX,ABX,ABX Air Inc,2,16240,0,0,0,0,16240,16240,0,16240,52942,0,0,0,0,52942,52942,0,52942,2015
7,19930,AS,AS,Alaska Airlines Inc.,3,38421654,0,0,592448,592448,39014102,38668993,592448,39261441,76772872,0,0,1136183,1136183,77909055,77210689,1136183,78346872,2015
7,20409,B6,B6,JetBlue Airways,3,52332601,0,0,13042093,13042093,65374694,52336513,13091665,65428178,102715537,0,0,25598300,25598300,128313837,102723978,25783270,128507248,2015
7,21167,CP,CP,Compass Airlines,2,0,0,0,0,0,0,0,0,0,0,0,0,0,0,0,0,0,0,2015
7,19790,DL,DL,Delta Air Lines Inc.,3,165185983,88133275,45783092,28596831,162513198,327699181,165878379,162513198,328391577,320924554,171225980,88947731,55558136,315731847,636656401,323303563,315731847,639035410,2015
7,20366,EV,EV,ExpressJet Airlines Inc.,3,106408,0,0,0,0,106408,106408,0,106408,315492,0,0,0,0,315492,315492,0,315492,2015
7,20436,F9,F9,Frontier Airlines Inc.,3,15785361,0,0,1318787,1318787,17104148,15842648,1318787,17161435,29729783,0,0,2731927,2731927,32461710,29839564,2731927,32571491,2015
7,20107,FX,FX,Federal Express Corporation,3,58621207,12409773,19669938,2218173,34297884,92919091,59591508,34796520,94388028,93172000,21237000,36428000,3972000,61637000,154809000,94812000,62586000,157398000,2015
7,20368,G4,G4,Allegiant Air,2,15547225,0,0,0,0,15547225,16007770,0,16007770,30339890,0,0,0,0,30339890,31277339,0,31277339,2015
7,20500,G7,G7,GoJet Airlines LLC d/b/a United Express,2,0,0,0,0,0,0,0,0,0,0,0,0,0,0,0,0,0,0,2015
7,20166,GFQ,GFQ,Gulf And Caribbean Cargo,1,0,0,0,0,0,0,78909,90065,168974,0,0,0,0,0,0,172204,214408,386612,2015
7,20402,GL,GL,Miami Air International,2,0,0,0,0,0,0,295185,326927,622112,0,0,0,0,0,0,673760,746211,1419971,2015
7,19690,HA,HA,Hawaiian Airlines Inc.,3,15187189,0,5890003,0,5890003,21077192,15202538,5890003,21092541,26884866,0,10706932,0,10706932,37591798,26911761,10706932,37618693,2015
7,20310,WL,K8,"Caribbean Sun Airlines, Inc. d/b/a World Atlantic Airlines",1,0,0,0,0,0,0,27418,439388,466806,0,0,0,0,0,0,62459,1000940,1063399,2015
7,20370,KAQ,KAQ,Kalitta Air LLC,2,0,0,0,0,0,0,606861,1677581,2284442,0,0,0,0,0,0,1417948,4138545,5556493,2015
7,21629,KD,KD,Western Global,1,0,0,0,0,0,0,18317,0,18317,0,0,0,0,0,0,18317,0,18317,2015
7,21634,KH,KH,Aloha Air Cargo,1,422110,0,0,0,0,422110,422110,0,422110,731821,0,0,0,0,731821,731821,0,731821,2015
7,20372,KLQ,KLQ,Kalitta Charters II,1,0,0,0,0,0,0,82070,49672,131742,0,0,0,0,0,0,184624,115431,300055,2015
7,20169,L2,L2,Lynden Air Cargo Airlines,1,80461,0,0,0,0,80461,244628,0,244628,234278,0,0,0,0,234278,509729,0,509729,2015
7,20151,M6,M6,Amerijet International,2,0,0,0,1478154,1478154,1478154,281433,1759602,2041035,0,0,0,2786228,2786228,2786228,530484,3316740,3847224,2015
7,20398,MQ,MQ,Envoy Air,3,0,0,0,0,0,0,0,0,0,0,0,0,0,0,0,0,0,0,2015
7,20405,N8,MRQ,"National Air Cargo Group, Inc. d/b/a Murray Air",1,0,0,0,0,0,0,61217,779004,840221,0,0,0,0,0,0,199187,7127247,7326434,2015
7,20108,NC,NC,Northern Air Cargo Inc.,1,417716,0,0,0,0,417716,568049,0,568049,827129,0,0,0,0,827129,1110307,0,1110307,2015
7,20416,NK,NK,Spirit Air Lines,3,20130428,0,0,2488030,2488030,22618458,20130428,2488030,22618458,37646874,0,0,4652984,4652984,42299858,37646874,4652984,42299858,2015
7,20397,OH,OH,PSA Airlines Inc.,2,0,0,0,0,0,0,0,0,0,0,0,0,0,0,0,0,0,0,2015
7,20304,OO,OO,SkyWest Airlines Inc.,3,5077358,0,0,0,0,5077358,5077358,0,5077358,11266087,0,0,0,0,11266087,11266087,0,11266087,2015
7,20177,PFQ,PFQ,Asia Pacific,1,0,0,0,0,0,0,0,281808,281808,0,0,0,0,0,0,0,695908,695908,2015
7,20100,PO,PO,Polar Air Cargo Airways,3,2784258,520078,11235570,0,11755648,14539906,2784258,11755648,14539906,5112466,1166931,20940897,0,22107828,27220294,5112466,22107828,27220294,2015
7,20149,PRQ,PRQ,Florida West Airlines Inc.,1,0,0,0,0,0,0,0,0,0,0,0,0,0,0,0,0,0,0,2015
7,19687,QX,QX,Horizon Air,2,0,0,0,0,0,0,0,0,0,0,0,0,0,0,0,0,0,0,2015
7,20448,S5,S5,Shuttle America Corp.,2,6954432,0,0,0,0,6954432,6954432,0,6954432,11676632,0,0,0,0,11676632,11676632,0,11676632,2015
7,20422,SY,SY,Sun Country Airlines d/b/a MN Airlines,2,3755275,0,0,320491,320491,4075766,4128996,469096,4598092,6902496,0,0,667214,667214,7569710,7839447,961294,8800741,2015
7,20447,U7,U7,USA Jet Airlines Inc.,2,0,0,0,0,0,0,318263,5392,323655,0,0,0,0,0,0,572641,14279,586920,2015
7,19977,UA,UA,United Air Lines Inc.,3,136747228,76679055,58180721,30639077,165498853,302246081,137650790,165918974,303569764,234705479,138271991,107228314,55663873,301164178,535869657,237596442,301962599,539559041,2015
7,21171,VX,VX,Virgin America,3,14979461,0,0,244962,244962,15224423,14991775,244962,15236737,26459690,0,0,460908,460908,26920598,26487452,460908,26948360,2015
7,20308,WE,WE,Centurion Cargo Inc.,2,0,0,0,0,0,0,0,1457996,1457996,0,0,0,0,0,0,0,2814939,2814939,2015
7,20195,WI,WI,Sky Lease Cargo,1,0,0,0,0,0,0,0,0,0,0,0,0,0,0,0,0,0,0,2015
7,20287,WP,WP,Island Air Hawaii,1,96694,0,0,0,0,96694,96694,0,96694,186483,0,0,0,0,186483,186483,0,186483,2015
7,20377,X9,X9,Omni Air Express,2,0,0,0,0,0,0,406897,2508273,2915170,0,0,0,0,0,0,742580,8102974,8845554,2015
7,20207,XP,XP,XTRA Airways,1,0,0,0,0,0,0,43850,446567,490417,0,0,0,0,0,0,114449,1165540,1279989,2015
7,20378,YV,YV,Mesa Airlines Inc.,2,0,0,0,0,0,0,0,0,0,0,0,0,0,0,0,0,0,0,2015
7,20452,YX,YX,Republic Airlines,2,15430476,0,0,0,0,15430476,15430476,0,15430476,27154965,0,0,0,0,27154965,27154965,0,27154965,2015
7,20046,ZW,ZW,Air Wisconsin Airlines Corp,2,7237519,0,0,0,0,7237519,7237519,0,7237519,14134661,0,0,0,0,14134661,14134661,0,14134661,2015
7,19393,WN,WN,Southwest Airlines Co.,3,176207727,0,0,1399229,1399229,177606956,176518232,1399229,177917461,334398287,0,0,2888364,2888364,337286651,334978520,2888364,337866884,2015
8,21236,0JQ,0JQ,Vision Airlines,1,0,0,0,0,0,0,39676,0,39676,0,0,0,0,0,0,62334,0,62334,2015
8,21352,0WQ,0WQ,Avjet Corporation,1,0,0,0,0,0,0,120866,41940,162806,0,0,0,0,0,0,384354,105269,489623,2015
8,21645,23Q,23Q,Songbird Airways Inc.,1,0,0,0,0,0,0,0,0,0,0,0,0,0,0,0,0,0,0,2015
8,21652,27Q,27Q,"Jet Aviation Flight Services, Inc.",1,0,0,0,0,0,0,0,0,0,0,0,0,0,0,0,0,0,0,2015
8,20408,5V,5V,Tatonduk Outfitters Limited d/b/a Everts Air Alaska and Everts Air Cargo,1,329842,0,0,0,0,329842,390175,0,390175,808087,0,0,0,0,808087,955898,0,955898,2015
8,19917,5X,5X,United Parcel Service,3,31350000,9728000,16445000,2929000,29102000,60452000,31350000,29102000,60452000,48203000,13759000,25262000,4846000,43867000,92070000,48203000,43867000,92070000,2015
8,20007,5Y,5Y,Atlas Air Inc.,3,0,0,0,0,0,0,6770543,28931975,35702518,0,0,0,0,0,0,15124318,65776367,80900685,2015
8,19874,8C,8C,Air Transport International,2,0,0,0,0,0,0,16468,779635,796103,0,0,0,0,0,0,41225,2294006,2335231,2015
8,20363,9E,9E,Endeavor Air Inc.,2,0,0,0,0,0,0,0,0,0,0,0,0,0,0,0,0,0,0,2015
8,20190,9S,9S,Southern Air Inc.,2,0,2553881,2835023,0,5388904,5388904,0,5388904,5388904,0,9245049,10262783,0,19507832,19507832,0,19507832,19507832,2015
8,19805,AA,AA,American Airlines Inc.,3,195905773,61519885,18633892,50096907,130250684,326156457,196608151,130458408,327066559,317685079,89907071,26393644,83505859,199806574,517491653,318770090,200161802,518931892,2015
8,20453,ABX,ABX,ABX Air Inc,2,46663,0,0,0,0,46663,46663,0,46663,108224,0,0,0,0,108224,108224,0,108224,2015
8,19930,AS,AS,Alaska Airlines Inc.,3,38627082,0,0,517942,517942,39145024,38688304,517942,39206246,68354981,0,0,884798,884798,69239779,68451612,884798,69336410,2015
8,20409,B6,B6,JetBlue Airways,3,51893463,0,0,13057730,13057730,64951193,51893463,13098686,64992149,93560858,0,0,23542318,23542318,117103176,93560858,23695139,117255997,2015
8,21167,CP,CP,Compass Airlines,2,0,0,0,0,0,0,0,0,0,0,0,0,0,0,0,0,0,0,2015
8,19790,DL,DL,Delta Air Lines Inc.,3,168041075,87396800,48205417,25053063,160655280,328696355,168924536,160659504,329584040,307324318,159836884,88161164,45818651,293816699,601141017,309895992,293824424,603720416,2015
8,20366,EV,EV,ExpressJet Airlines Inc.,3,93692,0,0,0,0,93692,93692,0,93692,242305,0,0,0,0,242305,242305,0,242305,2015
8,20436,F9,F9,Frontier Airlines Inc.,3,15824195,0,0,1022043,1022043,16846238,15868227,1022043,16890270,27043664,0,0,1915971,1915971,28959635,27126119,1915971,29042090,2015
8,20107,FX,FX,Federal Express Corporation,3,54569405,11438198,18944775,2106859,32489832,87059237,55497962,32896675,88394637,77765000,17322000,31532000,3500000,52354000,130119000,79216000,53036000,132252000,2015
8,20368,G4,G4,Allegiant Air,2,12366320,0,0,0,0,12366320,12825543,0,12825543,21890855,0,0,0,0,21890855,22762439,0,22762439,2015
8,20500,G7,G7,GoJet Airlines LLC d/b/a United Express,2,0,0,0,0,0,0,0,0,0,0,0,0,0,0,0,0,0,0,2015
8,20166,GFQ,GFQ,Gulf And Caribbean Cargo,1,0,0,0,0,0,0,232180,148624,380804,0,0,0,0,0,0,503871,319964,823835,2015
8,20402,GL,GL,Miami Air International,2,0,0,0,0,0,0,275360,310945,586305,0,0,0,0,0,0,626901,707917,1334818,2015
8,19690,HA,HA,Hawaiian Airlines Inc.,3,15212466,0,5870667,0,5870667,21083133,15212466,5870667,21083133,24445148,0,9992159,0,9992159,34437307,24445148,9992159,34437307,2015
8,20310,WL,K8,"Caribbean Sun Airlines, Inc. d/b/a World Atlantic Airlines",1,0,0,0,0,0,0,47179,337459,384638,0,0,0,0,0,0,93275,667171,760446,2015
8,20370,KAQ,KAQ,Kalitta Air LLC,2,0,0,0,0,0,0,465975,1712021,2177996,0,0,0,0,0,0,949520,3509927,4459447,2015
8,21629,KD,KD,Western Global,1,0,0,0,0,0,0,111859,0,111859,0,0,0,0,0,0,111859,0,111859,2015
8,21634,KH,KH,Aloha Air Cargo,1,435947,0,0,0,0,435947,435947,0,435947,659061,0,0,0,0,659061,659061,0,659061,2015
8,20372,KLQ,KLQ,Kalitta Charters II,1,0,0,0,0,0,0,132138,106893,239031,0,0,0,0,0,0,271263,240919,512182,2015
8,20169,L2,L2,Lynden Air Cargo Airlines,1,79367,0,0,0,0,79367,200673,0,200673,203158,0,0,0,0,203158,495425,0,495425,2015
8,20151,M6,M6,Amerijet International,2,0,0,0,1419892,1419892,1419892,300582,1555205,1855787,0,0,0,2407898,2407898,2407898,509736,2637366,3147102,2015
8,20398,MQ,MQ,Envoy Air,3,0,0,0,0,0,0,0,0,0,0,0,0,0,0,0,0,0,0,2015
8,20405,N8,MRQ,"National Air Cargo Group, Inc. d/b/a Murray Air",1,0,0,0,0,0,0,0,857599,857599,0,0,0,0,0,0,0,2217327,2217327,2015
8,20108,NC,NC,Northern Air Cargo Inc.,1,472833,0,0,0,0,472833,602262,13311,615573,852681,0,0,0,0,852681,1089047,27644,1116691,2015
8,20416,NK,NK,Spirit Air Lines,3,21128862,0,0,2505212,2505212,23634074,21128862,2505212,23634074,35201541,0,0,4173785,4173785,39375326,35201541,4173785,39375326,2015
8,20397,OH,OH,PSA Airlines Inc.,2,0,0,0,0,0,0,0,0,0,0,0,0,0,0,0,0,0,0,2015
8,20304,OO,OO,SkyWest Airlines Inc.,3,5152349,0,0,0,0,5152349,5152349,0,5152349,10273097,0,0,0,0,10273097,10273097,0,10273097,2015
8,20177,PFQ,PFQ,Asia Pacific,1,0,0,0,0,0,0,0,289437,289437,0,0,0,0,0,0,0,675999,675999,2015
8,20100,PO,PO,Polar Air Cargo Airways,3,2568934,548550,9729510,0,10278060,12846994,2568934,10278060,12846994,4233449,1130550,16293283,0,17423833,21657282,4233449,17423833,21657282,2015
8,20149,PRQ,PRQ,Florida West Airlines Inc.,1,0,0,0,0,0,0,0,0,0,0,0,0,0,0,0,0,0,0,2015
8,19687,QX,QX,Horizon Air,2,0,0,0,0,0,0,0,0,0,0,0,0,0,0,0,0,0,0,2015
8,20448,S5,S5,Shuttle America Corp.,2,7066823,0,0,0,0,7066823,7066823,0,7066823,10640375,0,0,0,0,10640375,10640375,0,10640375,2015
8,20422,SY,SY,Sun Country Airlines d/b/a MN Airlines,2,3524286,0,0,357435,357435,3881721,4046304,586489,4632793,5838707,0,0,639531,639531,6478238,7073932,1018124,8092056,2015
8,20447,U7,U7,USA Jet Airlines Inc.,2,0,0,0,0,0,0,437828,9879,447707,0,0,0,0,0,0,716628,25765,742393,2015
8,19977,UA,UA,United Air Lines Inc.,3,131670622,75971030,59033878,27936497,162941405,294612027,133231965,163585985,296817950,202059347,122044474,96310173,45767823,264122470,466181817,206484566,265177392,471661958,2015
8,21171,VX,VX,Virgin America,3,15012971,0,0,196431,196431,15209402,15076156,196431,15272587,24095124,0,0,331884,331884,24427008,24214310,331884,24546194,2015
8,20308,WE,WE,Centurion Cargo Inc.,2,0,0,0,0,0,0,0,763058,763058,0,0,0,0,0,0,0,1425570,1425570,2015
8,20195,WI,WI,Sky Lease Cargo,1,0,0,0,0,0,0,0,0,0,0,0,0,0,0,0,0,0,0,2015
8,20287,WP,WP,Island Air Hawaii,1,97531,0,0,0,0,97531,97531,0,97531,173454,0,0,0,0,173454,173454,0,173454,2015
8,20377,X9,X9,Omni Air Express,2,0,0,0,0,0,0,370669,2308323,2678992,0,0,0,0,0,0,670913,7757965,8428878,2015
8,20207,XP,XP,XTRA Airways,1,0,0,0,0,0,0,35595,245356,280951,0,0,0,0,0,0,74160,511185,585345,2015
8,20378,YV,YV,Mesa Airlines Inc.,2,0,0,0,0,0,0,0,0,0,0,0,0,0,0,0,0,0,0,2015
8,20452,YX,YX,Republic Airlines,2,14684188,0,0,0,0,14684188,14684188,0,14684188,23058025,0,0,0,0,23058025,23058025,0,23058025,2015
8,20046,ZW,ZW,Air Wisconsin Airlines Corp,2,7127324,0,0,0,0,7127324,7127324,0,7127324,12331499,0,0,0,0,12331499,12331499,0,12331499,2015
8,19393,WN,WN,Southwest Airlines Co.,3,163921515,0,0,927313,927313,164848828,164255807,927313,165183120,288106873,0,0,1727193,1727193,289834066,288684674,1727193,290411867,2015
9,21236,0JQ,0JQ,Vision Airlines,1,0,0,0,0,0,0,30827,0,30827,0,0,0,0,0,0,83913,0,83913,2015
9,21352,0WQ,0WQ,Avjet Corporation,1,0,0,0,0,0,0,142989,52395,195384,0,0,0,0,0,0,426107,130463,556570,2015
9,21645,23Q,23Q,Songbird Airways Inc.,1,0,0,0,0,0,0,0,0,0,0,0,0,0,0,0,0,0,0,2015
9,21652,27Q,27Q,"Jet Aviation Flight Services, Inc.",1,0,0,0,0,0,0,0,0,0,0,0,0,0,0,0,0,0,0,2015
9,20408,5V,5V,Tatonduk Outfitters Limited d/b/a Everts Air Alaska and Everts Air Cargo,1,286148,0,0,0,0,286148,413895,0,413895,738416,0,0,0,0,738416,1068072,0,1068072,2015
9,19917,5X,5X,United Parcel Service,3,32737000,10122000,15748000,2975000,28845000,61582000,32737000,28845000,61582000,48379000,13272000,22355000,4694000,40321000,88700000,48379000,40321000,88700000,2015
9,20007,5Y,5Y,Atlas Air Inc.,3,0,0,0,0,0,0,8729832,37408377,46138209,0,0,0,0,0,0,18356399,81764567,100120966,2015
9,19874,8C,8C,Air Transport International,2,0,0,0,0,0,0,2873,664143,667016,0,0,0,0,0,0,4642,1970730,1975372,2015
9,20363,9E,9E,Endeavor Air Inc.,2,0,0,0,0,0,0,0,0,0,0,0,0,0,0,0,0,0,0,2015
9,19805,AA,AA,American Airlines Inc.,3,173332233,59590592,18011865,40958807,118561264,291893497,173943012,118701936,292644948,262740494,81617873,23361912,64559699,169539484,432279978,263625973,169748674,433374647,2015
9,20453,ABX,ABX,ABX Air Inc,2,71385,0,0,0,0,71385,71385,0,71385,137773,0,0,0,0,137773,137773,0,137773,2015
9,19930,AS,AS,Alaska Airlines Inc.,3,34442972,0,0,389960,389960,34832932,34534129,389960,34924089,57880465,0,0,631444,631444,58511909,58015853,631444,58647297,2015
9,20409,B6,B6,JetBlue Airways,3,45286615,0,0,9337869,9337869,54624484,45395551,9381753,54777304,79656760,0,0,16424818,16424818,96081578,79937250,16533982,96471232,2015
9,21167,CP,CP,Compass Airlines,2,0,0,0,0,0,0,0,0,0,0,0,0,0,0,0,0,0,0,2015
9,19790,DL,DL,Delta Air Lines Inc.,3,140390716,77021906,43844486,20423587,141289979,281680695,141344063,141336965,282681028,236325071,129653925,73805103,34379806,237838834,474163905,238849459,237917928,476767387,2015
9,20366,EV,EV,ExpressJet Airlines Inc.,3,66005,0,0,0,0,66005,66005,0,66005,213211,0,0,0,0,213211,213211,0,213211,2015
9,20436,F9,F9,Frontier Airlines Inc.,3,15234155,0,0,716431,716431,15950586,15286946,716431,16003377,21360603,0,0,1108963,1108963,22469566,21436220,1108963,22545183,2015
9,20107,FX,FX,Federal Express Corporation,3,55354956,11976150,18820236,2108873,32905259,88260215,56281810,33406698,89688508,79714000,17983000,28384000,3594000,49961000,129675000,81036000,50975000,132011000,2015
9,20368,G4,G4,Allegiant Air,2,8203173,0,0,0,0,8203173,8684843,0,8684843,14015333,0,0,0,0,14015333,14929816,0,14929816,2015
9,20500,G7,G7,GoJet Airlines LLC d/b/a United Express,2,0,0,0,0,0,0,0,0,0,0,0,0,0,0,0,0,0,0,2015
9,20166,GFQ,GFQ,Gulf And Caribbean Cargo,1,0,0,0,0,0,0,341463,98764,440227,0,0,0,0,0,0,669610,218314,887924,2015
9,20402,GL,GL,Miami Air International,2,0,0,0,0,0,0,305282,117762,423044,0,0,0,0,0,0,714604,275657,990261,2015
9,19690,HA,HA,Hawaiian Airlines Inc.,3,13334860,0,5610598,0,5610598,18945458,13392833,5610598,19003431,20505420,0,8875692,0,8875692,29381112,20595770,8875692,29471462,2015
9,20310,WL,K8,"Caribbean Sun Airlines, Inc. d/b/a World Atlantic Airlines",1,0,0,0,0,0,0,46985,247955,294940,0,0,0,0,0,0,89588,472786,562374,2015
9,20370,KAQ,KAQ,Kalitta Air LLC,2,0,0,0,0,0,0,588033,2271862,2859895,0,0,0,0,0,0,1245528,4476752,5722280,2015
9,21629,KD,KD,Western Global,1,0,0,0,0,0,0,8723,0,8723,0,0,0,0,0,0,8723,0,8723,2015
9,21634,KH,KH,Aloha Air Cargo,1,429319,0,0,0,0,429319,429319,0,429319,634692,0,0,0,0,634692,634692,0,634692,2015
9,20372,KLQ,KLQ,Kalitta Charters II,1,0,0,0,0,0,0,334744,51886,386630,0,0,0,0,0,0,674325,108053,782378,2015
9,20169,L2,L2,Lynden Air Cargo Airlines,1,92782,0,0,0,0,92782,189034,3374,192408,216944,0,0,0,0,216944,441775,5370,447145,2015
9,20151,M6,M6,Amerijet International,2,0,0,0,1390956,1390956,1390956,227343,1525329,1752672,0,0,0,2294892,2294892,2294892,375086,2516590,2891676,2015
9,20398,MQ,MQ,Envoy Air,3,0,0,0,0,0,0,0,0,0,0,0,0,0,0,0,0,0,0,2015
9,20405,N8,MRQ,"National Air Cargo Group, Inc. d/b/a Murray Air",1,0,0,0,0,0,0,102117,538419,640536,0,0,0,0,0,0,227848,1216937,1444785,2015
9,20108,NC,NC,Northern Air Cargo Inc.,1,405248,0,0,0,0,405248,587910,0,587910,688863,0,0,0,0,688863,1045705,0,1045705,2015
9,20416,NK,NK,Spirit Air Lines,3,19673923,0,0,1757366,1757366,21431289,19673923,1757366,21431289,31412058,0,0,2805870,2805870,34217928,31412058,2805870,34217928,2015
9,20397,OH,OH,PSA Airlines Inc.,2,0,0,0,0,0,0,0,0,0,0,0,0,0,0,0,0,0,0,2015
9,20304,OO,OO,SkyWest Airlines Inc.,3,5250159,0,0,0,0,5250159,5250159,0,5250159,9365705,0,0,0,0,9365705,9365705,0,9365705,2015
9,20177,PFQ,PFQ,Asia Pacific,1,0,0,0,0,0,0,0,283640,283640,0,0,0,0,0,0,0,627632,627632,2015
9,20100,PO,PO,Polar Air Cargo Airways,3,2676198,614214,11235729,0,11849943,14526141,2676198,11849943,14526141,4249582,1216455,16449482,0,17665937,21915519,4249582,17665937,21915519,2015
9,20149,PRQ,PRQ,Florida West Airlines Inc.,1,0,0,0,0,0,0,0,0,0,0,0,0,0,0,0,0,0,0,2015
9,19687,QX,QX,Horizon Air,2,0,0,0,0,0,0,0,0,0,0,0,0,0,0,0,0,0,0,2015
9,20448,S5,S5,Shuttle America Corp.,2,6363950,0,0,0,0,6363950,6363950,0,6363950,9208147,0,0,0,0,9208147,9208147,0,9208147,2015
9,20422,SY,SY,Sun Country Airlines d/b/a MN Airlines,2,2715339,0,0,131539,131539,2846878,3236172,263248,3499420,4363140,0,0,222763,222763,4585903,5981104,445062,6426166,2015
9,20447,U7,U7,USA Jet Airlines Inc.,2,0,0,0,0,0,0,620730,13541,634271,0,0,0,0,0,0,988066,27196,1015262,2015
9,19977,UA,UA,United Air Lines Inc.,3,116786479,69353181,55777593,18453888,143584662,260371141,118074789,144094558,262169347,171612009,103955328,83580600,28434448,215970376,387582385,174087571,216729919,390817490,2015
9,21171,VX,VX,Virgin America,3,13673890,0,0,118773,118773,13792663,13737167,118773,13855940,22030086,0,0,191189,191189,22221275,22139973,191189,22331162,2015
9,20308,WE,WE,Centurion Cargo Inc.,2,0,0,0,0,0,0,0,694383,694383,0,0,0,0,0,0,0,1098608,1098608,2015
9,20195,WI,WI,Sky Lease Cargo,1,0,0,0,0,0,0,0,0,0,0,0,0,0,0,0,0,0,0,2015
9,20287,WP,WP,Island Air Hawaii,1,95750,0,0,0,0,95750,95750,0,95750,157122,0,0,0,0,157122,157122,0,157122,2015
9,20377,X9,X9,Omni Air Express,2,0,0,0,0,0,0,347283,2634262,2981545,0,0,0,0,0,0,603415,9247405,9850820,2015
9,20207,XP,XP,XTRA Airways,1,0,0,0,0,0,0,112156,113183,225339,0,0,0,0,0,0,242103,244320,486423,2015
9,20378,YV,YV,Mesa Airlines Inc.,2,0,0,0,0,0,0,0,0,0,0,0,0,0,0,0,0,0,0,2015
9,20452,YX,YX,Republic Airlines,2,13330049,0,0,0,0,13330049,13330049,0,13330049,19660939,0,0,0,0,19660939,19660939,0,19660939,2015
9,20046,ZW,ZW,Air Wisconsin Airlines Corp,2,6636047,0,0,0,0,6636047,6636047,0,6636047,10897010,0,0,0,0,10897010,10897010,0,10897010,2015
9,19393,WN,WN,Southwest Airlines Co.,3,150235332,0,0,609308,609308,150844640,150538427,609308,151147735,259602871,0,0,1104824,1104824,260707695,260093262,1104824,261198086,2015
10,21352,0WQ,0WQ,Avjet Corporation,1,0,0,0,0,0,0,141842,13388,155230,0,0,0,0,0,0,441129,34541,475670,2015
10,21645,23Q,23Q,Songbird Airways Inc.,1,0,0,0,0,0,0,0,0,0,0,0,0,0,0,0,0,0,0,2015
10,21652,27Q,27Q,"Jet Aviation Flight Services, Inc.",1,0,0,0,0,0,0,0,0,0,0,0,0,0,0,0,0,0,0,2015
10,20408,5V,5V,Tatonduk Outfitters Limited d/b/a Everts Air Alaska and Everts Air Cargo,1,355064,0,0,0,0,355064,440269,0,440269,831528,0,0,0,0,831528,1031071,0,1031071,2015
10,19917,5X,5X,United Parcel Service,3,33826000,10290000,16521000,3080000,29891000,63717000,33826000,29891000,63717000,50319000,13508000,23889000,4880000,42277000,92596000,50319000,42277000,92596000,2015
10,20007,5Y,5Y,Atlas Air Inc.,3,0,0,0,0,0,0,5507677,25933189,31440866,0,0,0,0,0,0,11575198,54239149,65814347,2015
10,19874,8C,8C,Air Transport International,2,0,0,0,0,0,0,26362,892003,918365,0,0,0,0,0,0,54396,2439258,2493654,2015
10,20363,9E,9E,Endeavor Air Inc.,2,0,0,0,0,0,0,0,0,0,0,0,0,0,0,0,0,0,0,2015
10,20190,9S,9S,Southern Air Inc.,2,580339,4954307,852749,0,5807056,6387395,580339,5807056,6387395,2100827,17934591,3086951,0,21021542,23122369,2100827,21021542,23122369,2015
10,19805,AA,AA,American Airlines Inc.,3,181467846,54484651,18142050,43850601,116477302,297945148,182248475,116567765,298816240,268987608,75897693,25174008,70236839,171308540,440296148,270111807,171447419,441559226,2015
10,20453,ABX,ABX,ABX Air Inc,2,38448,0,0,0,0,38448,38448,0,38448,0,0,0,0,0,0,0,0,0,2015
10,19930,AS,AS,Alaska Airlines Inc.,3,35670427,0,0,691675,691675,36362102,35773954,691675,36465629,60025510,0,0,1146415,1146415,61171925,60179138,1146415,61325553,2015
10,20409,B6,B6,JetBlue Airways,3,46746414,0,0,9825080,9825080,56571494,46849602,9874028,56723630,81481942,0,0,17125733,17125733,98607675,81760207,17247494,99007701,2015
10,21167,CP,CP,Compass Airlines,2,0,0,0,0,0,0,0,0,0,0,0,0,0,0,0,0,0,0,2015
10,19790,DL,DL,Delta Air Lines Inc.,3,147658495,67303159,38859432,21293053,127455644,275114139,149249455,128211412,277460867,303123407,138164506,79773287,43711827,261649620,564773027,307188806,263201111,570389917,2015
10,21650,EE,EE,Eastern Airlines Group Inc.,1,0,0,0,0,0,0,80320,114960,195280,0,0,0,0,0,0,142970,204629,347599,2015
10,20366,EV,EV,ExpressJet Airlines Inc.,3,81937,0,0,0,0,81937,81937,0,81937,208003,0,0,0,0,208003,208003,0,208003,2015
10,20436,F9,F9,Frontier Airlines Inc.,3,15956961,0,0,943502,943502,16900463,15992985,943502,16936487,22478579,0,0,1475956,1475956,23954535,22532980,1475956,24008936,2015
10,20107,FX,FX,Federal Express Corporation,3,59050342,12271992,19223194,2286542,33781728,92832070,59961832,34521062,94482894,86175000,18474000,29442000,3749000,51665000,137840000,87535000,53216000,140751000,2015
10,20368,G4,G4,Allegiant Air,2,11112227,0,0,0,0,11112227,11672418,0,11672418,19128201,0,0,0,0,19128201,20222240,0,20222240,2015
10,20500,G7,G7,GoJet Airlines LLC d/b/a United Express,2,0,0,0,0,0,0,0,0,0,0,0,0,0,0,0,0,0,0,2015
10,20166,GFQ,GFQ,Gulf And Caribbean Cargo,1,0,0,0,0,0,0,358063,117659,475722,0,0,0,0,0,0,699230,235143,934373,2015
10,20402,GL,GL,Miami Air International,2,0,0,0,0,0,0,399822,204655,604477,0,0,0,0,0,0,864255,442382,1306637,2015
10,19690,HA,HA,Hawaiian Airlines Inc.,3,13422164,0,5922001,0,5922001,19344165,13467745,5922001,19389746,20400176,0,9296046,0,9296046,29696222,20470030,9296046,29766076,2015
10,20370,KAQ,KAQ,Kalitta Air LLC,2,0,0,0,0,0,0,476885,2868697,3345582,0,0,0,0,0,0,917885,5827918,6745803,2015
10,21629,KD,KD,Western Global,1,0,0,0,0,0,0,2233,0,2233,0,0,0,0,0,0,2233,0,2233,2015
10,21634,KH,KH,Aloha Air Cargo,1,446107,0,0,0,0,446107,446107,0,446107,674712,0,0,0,0,674712,674712,0,674712,2015
10,20372,KLQ,KLQ,Kalitta Charters II,1,0,0,0,0,0,0,275235,30046,305281,0,0,0,0,0,0,557706,63048,620754,2015
10,20169,L2,L2,Lynden Air Cargo Airlines,1,101353,0,0,0,0,101353,211068,77504,288572,212572,0,0,0,0,212572,455118,164289,619407,2015
10,20151,M6,M6,Amerijet International,2,0,0,0,1428985,1428985,1428985,499204,1560925,2060129,0,0,0,2406430,2406430,2406430,840666,2628619,3469285,2015
10,20398,MQ,MQ,Envoy Air,3,0,0,0,0,0,0,0,0,0,0,0,0,0,0,0,0,0,0,2015
10,20405,N8,MRQ,"National Air Cargo Group, Inc. d/b/a Murray Air",1,0,0,0,0,0,0,65736,742202,807938,0,0,0,0,0,0,107154,1731039,1838193,2015
10,20108,NC,NC,Northern Air Cargo Inc.,1,430278,0,0,0,0,430278,688066,0,688066,724545,0,0,0,0,724545,1230807,0,1230807,2015
10,20416,NK,NK,Spirit Air Lines,3,20395753,0,0,1558771,1558771,21954524,20395753,1558771,21954524,33263004,0,0,2542167,2542167,35805171,33263004,2542167,35805171,2015
10,20397,OH,OH,PSA Airlines Inc.,2,0,0,0,0,0,0,0,0,0,0,0,0,0,0,0,0,0,0,2015
10,20304,OO,OO,SkyWest Airlines Inc.,3,4711398,0,0,0,0,4711398,4711398,0,4711398,9706354,0,0,0,0,9706354,9706354,0,9706354,2015
10,20177,PFQ,PFQ,Asia Pacific,1,0,0,0,0,0,0,0,279057,279057,0,0,0,0,0,0,0,631727,631727,2015
10,20100,PO,PO,Polar Air Cargo Airways,3,3018145,688887,12108321,0,12797208,15815353,3018145,12797208,15815353,4688076,1323961,17803951,0,19127912,23815988,4688076,19127912,23815988,2015
10,20149,PRQ,PRQ,Florida West Airlines Inc.,1,0,0,0,0,0,0,0,0,0,0,0,0,0,0,0,0,0,0,2015
10,19687,QX,QX,Horizon Air,2,0,0,0,0,0,0,0,0,0,0,0,0,0,0,0,0,0,0,2015
10,20448,S5,S5,Shuttle America Corp.,2,6451193,0,0,0,0,6451193,6451193,0,6451193,9406213,0,0,0,0,9406213,9406213,0,9406213,2015
10,20422,SY,SY,Sun Country Airlines d/b/a MN Airlines,2,3097212,0,0,246909,246909,3344121,3515001,324895,3839896,5061983,0,0,425549,425549,5487532,6495282,595965,7091247,2015
10,20447,U7,U7,USA Jet Airlines Inc.,2,0,0,0,0,0,0,577908,3029,580937,0,0,0,0,0,0,926271,7651,933922,2015
10,19977,UA,UA,United Air Lines Inc.,3,125236942,65873770,57099199,21025250,143998219,269235161,127117672,144626488,271744160,184248134,98906077,85788297,32198019,216892393,401140527,188657628,217860330,406517958,2015
10,21171,VX,VX,Virgin America,3,14514238,0,0,138449,138449,14652687,14580153,138449,14718602,23050250,0,0,226347,226347,23276597,23156297,226347,23382644,2015
10,20308,WE,WE,Centurion Cargo Inc.,2,0,0,0,0,0,0,0,393727,393727,0,0,0,0,0,0,0,635275,635275,2015
10,20195,WI,WI,Sky Lease Cargo,1,0,0,0,0,0,0,0,0,0,0,0,0,0,0,0,0,0,0,2015
10,20287,WP,WP,Island Air Hawaii,1,104172,0,0,0,0,104172,104172,0,104172,158457,0,0,0,0,158457,158457,0,158457,2015
10,20377,X9,X9,Omni Air Express,2,0,0,0,0,0,0,326188,3033621,3359809,0,0,0,0,0,0,526139,6932872,7459011,2015
10,20207,XP,XP,XTRA Airways,1,0,0,0,0,0,0,246721,266349,513070,0,0,0,0,0,0,567549,612701,1180250,2015
10,20378,YV,YV,Mesa Airlines Inc.,2,0,0,0,0,0,0,0,0,0,0,0,0,0,0,0,0,0,0,2015
10,20452,YX,YX,Republic Airlines,2,13190456,0,0,0,0,13190456,13190456,0,13190456,19321347,0,0,0,0,19321347,19321347,0,19321347,2015
10,20046,ZW,ZW,Air Wisconsin Airlines Corp,2,6797089,0,0,0,0,6797089,6797089,0,6797089,10657733,0,0,0,0,10657733,10657733,0,10657733,2015
10,19393,WN,WN,Southwest Airlines Co.,3,157094706,0,0,877350,877350,157972056,157449231,877350,158326581,256156825,0,0,1595601,1595601,257752426,256733693,1595601,258329294,2015
11,21352,0WQ,0WQ,Avjet Corporation,1,0,0,0,0,0,0,154497,39776,194273,0,0,0,0,0,0,437227,108171,545398,2015
11,21645,23Q,23Q,Songbird Airways Inc.,1,0,0,0,0,0,0,0,0,0,0,0,0,0,0,0,0,0,0,2015
11,21652,27Q,27Q,"Jet Aviation Flight Services, Inc.",1,0,0,0,0,0,0,0,0,0,0,0,0,0,0,0,0,0,0,2015
11,20408,5V,5V,Tatonduk Outfitters Limited d/b/a Everts Air Alaska and Everts Air Cargo,1,269361,0,0,0,0,269361,291529,0,291529,619441,0,0,0,0,619441,787493,0,787493,2015
11,19917,5X,5X,United Parcel Service,3,33510000,10701000,17886000,3058000,31645000,65155000,33510000,31645000,65155000,48866000,14150000,25693000,4784000,44627000,93493000,48866000,44627000,93493000,2015
11,20007,5Y,5Y,Atlas Air Inc.,3,0,0,0,0,0,0,5192984,24936857,30129841,0,0,0,0,0,0,10288436,47623279,57911715,2015
11,19874,8C,8C,Air Transport International,2,0,0,0,0,0,0,13007,779112,792119,0,0,0,0,0,0,28356,2190570,2218926,2015
11,20363,9E,9E,Endeavor Air Inc.,2,0,0,0,0,0,0,0,0,0,0,0,0,0,0,0,0,0,0,2015
11,20190,9S,9S,Southern Air Inc.,2,821760,4482421,562561,0,5044982,5866742,821760,5044982,5866742,2974771,16226364,2036471,0,18262835,21237606,2974771,18262835,21237606,2015
11,19805,AA,AA,American Airlines Inc.,3,174444871,38868245,16263937,46702449,101834631,276279502,175115641,102047752,277163393,257641995,48778257,21799719,72427831,143005807,400647802,258576557,143322385,401898942,2015
11,20453,ABX,ABX,ABX Air Inc,2,146031,0,0,0,0,146031,146031,0,146031,339974,0,0,0,0,339974,339974,0,339974,2015
11,19930,AS,AS,Alaska Airlines Inc.,3,36293582,0,0,974672,974672,37268254,36371183,974672,37345855,58768448,0,0,7313938,7313938,66082386,58879494,7313938,66193432,2015
11,20409,B6,B6,JetBlue Airways,3,46844833,0,0,10013634,10013634,56858467,46907005,10060578,56967583,81382646,0,0,17396497,17396497,98779143,81540334,17499810,99040144,2015
11,21167,CP,CP,Compass Airlines,2,0,0,0,0,0,0,0,0,0,0,0,0,0,0,0,0,0,0,2015
11,19790,DL,DL,Delta Air Lines Inc.,3,141593450,52389555,34717954,21634735,108742244,250335694,143032267,109368306,252400573,259734379,96101680,63685476,39686048,199473204,459207583,263162486,200621632,463784118,2015
11,21650,EE,EE,Eastern Airlines Group Inc.,1,0,0,0,0,0,0,116560,122240,238800,0,0,0,0,0,0,207477,217587,425064,2015
11,20366,EV,EV,ExpressJet Airlines Inc.,3,79796,0,0,0,0,79796,79796,0,79796,183504,0,0,0,0,183504,183504,0,183504,2015
11,20436,F9,F9,Frontier Airlines Inc.,3,15723974,0,0,1615992,1615992,17339966,15795114,1615992,17411106,21778905,0,0,2480424,2480424,24259329,21882901,2480424,24363325,2015
11,20107,FX,FX,Federal Express Corporation,3,53347693,11314401,19118215,1907970,32340586,85688279,54908619,32720232,87628851,75966000,16638000,29159000,3060000,48857000,124823000,78236000,49576000,127812000,2015
11,20368,G4,G4,Allegiant Air,2,11897512,0,0,0,0,11897512,12449136,0,12449136,19793118,0,0,0,0,19793118,20825127,0,20825127,2015
11,20500,G7,G7,GoJet Airlines LLC d/b/a United Express,2,0,0,0,0,0,0,0,0,0,0,0,0,0,0,0,0,0,0,2015
11,20166,GFQ,GFQ,Gulf And Caribbean Cargo,1,0,0,0,0,0,0,208771,215462,424233,0,0,0,0,0,0,398547,430236,828783,2015
11,20402,GL,GL,Miami Air International,2,0,0,0,0,0,0,469604,149322,618926,0,0,0,0,0,0,1047734,333152,1380886,2015
11,19690,HA,HA,Hawaiian Airlines Inc.,3,13038334,0,5606581,0,5606581,18644915,13116519,5606581,18723100,19056590,0,8504953,0,8504953,27561543,19170792,8504953,27675745,2015
11,20310,WL,K8,"Caribbean Sun Airlines, Inc. d/b/a World Atlantic Airlines",1,0,0,0,0,0,0,76627,144508,221135,0,0,0,0,0,0,169000,318711,487711,2015
11,20370,KAQ,KAQ,Kalitta Air LLC,2,0,0,0,0,0,0,753176,3384195,4137371,0,0,0,0,0,0,1551297,6054972,7606269,2015
11,21629,KD,KD,Western Global,1,0,0,0,0,0,0,34116,0,34116,0,0,0,0,0,0,34116,0,34116,2015
11,21634,KH,KH,Aloha Air Cargo,1,433446,0,0,0,0,433446,433446,0,433446,640245,0,0,0,0,640245,640245,0,640245,2015
11,20372,KLQ,KLQ,Kalitta Charters II,1,0,0,0,0,0,0,155347,124362,279709,0,0,0,0,0,0,332680,249756,582436,2015
11,20169,L2,L2,Lynden Air Cargo Airlines,1,151543,0,0,0,0,151543,382460,64100,446560,77157,0,0,0,0,77157,165523,73357,238880,2015
11,20151,M6,M6,Amerijet International,2,0,0,0,1685135,1685135,1685135,364513,1827866,2192379,0,0,0,2752256,2752256,2752256,595343,2985372,3580715,2015
11,20398,MQ,MQ,Envoy Air,3,0,0,0,0,0,0,0,0,0,0,0,0,0,0,0,0,0,0,2015
11,20405,N8,MRQ,"National Air Cargo Group, Inc. d/b/a Murray Air",1,0,0,0,0,0,0,51749,775735,827484,0,0,0,0,0,0,139375,2040478,2179853,2015
11,20108,NC,NC,Northern Air Cargo Inc.,1,325559,0,0,0,0,325559,528552,23132,551684,540428,0,0,0,0,540428,930464,45615,976079,2015
11,20416,NK,NK,Spirit Air Lines,3,20168432,0,0,1897686,1897686,22066118,20168432,1897686,22066118,32293975,0,0,3038602,3038602,35332577,32293975,3038602,35332577,2015
11,20397,OH,OH,PSA Airlines Inc.,2,0,0,0,0,0,0,0,0,0,0,0,0,0,0,0,0,0,0,2015
11,20304,OO,OO,SkyWest Airlines Inc.,3,4926591,0,0,0,0,4926591,4926591,0,4926591,9215756,0,0,0,0,9215756,9215756,0,9215756,2015
11,20177,PFQ,PFQ,Asia Pacific,1,0,0,0,0,0,0,0,248199,248199,0,0,0,0,0,0,0,560959,560959,2015
11,20100,PO,PO,Polar Air Cargo Airways,3,2949409,746987,12142852,0,12889839,15839248,2949409,12889839,15839248,4498730,1422087,18134298,0,19556385,24055115,4498730,19556385,24055115,2015
11,20149,PRQ,PRQ,Florida West Airlines Inc.,1,0,0,0,0,0,0,0,0,0,0,0,0,0,0,0,0,0,0,2015
11,19687,QX,QX,Horizon Air,2,0,0,0,0,0,0,0,0,0,0,0,0,0,0,0,0,0,0,2015
11,20448,S5,S5,Shuttle America Corp.,2,5733889,0,0,0,0,5733889,5733889,0,5733889,8075751,0,0,0,0,8075751,8075751,0,8075751,2015
11,20422,SY,SY,Sun Country Airlines d/b/a MN Airlines,2,3193832,0,0,328875,328875,3522707,3628971,370667,3999638,5061127,0,0,550268,550268,5611395,6466883,625348,7092231,2015
11,20447,U7,U7,USA Jet Airlines Inc.,2,0,0,0,0,0,0,548629,18165,566794,0,0,0,0,0,0,861348,51581,912929,2015
11,19977,UA,UA,United Air Lines Inc.,3,115553075,52975706,52497788,25209668,130683162,246236237,116727559,131117178,247844737,159043433,74265024,75196664,36699950,186161638,345205071,161410369,186831647,348242016,2015
11,21171,VX,VX,Virgin America,3,14346522,0,0,178378,178378,14524900,14453544,178378,14631922,20219919,0,0,286876,286876,20506795,20381485,286876,20668361,2015
11,20308,WE,WE,Centurion Cargo Inc.,2,0,0,0,0,0,0,0,751511,751511,0,0,0,0,0,0,0,1186434,1186434,2015
11,20195,WI,WI,Sky Lease Cargo,1,0,0,0,0,0,0,0,0,0,0,0,0,0,0,0,0,0,0,2015
11,20287,WP,WP,Island Air Hawaii,1,94766,0,0,0,0,94766,94766,0,94766,151693,0,0,0,0,151693,151693,0,151693,2015
11,20377,X9,X9,Omni Air Express,2,0,0,0,0,0,0,376054,1317422,1693476,0,0,0,0,0,0,671608,3403426,4075034,2015
11,20207,XP,XP,XTRA Airways,1,0,0,0,0,0,0,320682,277454,598136,0,0,0,0,0,0,685069,592722,1277791,2015
11,20378,YV,YV,Mesa Airlines Inc.,2,0,0,0,0,0,0,0,0,0,0,0,0,0,0,0,0,0,0,2015
11,20452,YX,YX,Republic Airlines,2,12031506,0,0,0,0,12031506,12031506,0,12031506,17367680,0,0,0,0,17367680,17367680,0,17367680,2015
11,20046,ZW,ZW,Air Wisconsin Airlines Corp,2,6380123,0,0,0,0,6380123,6380123,0,6380123,9797346,0,0,0,0,9797346,9797346,0,9797346,2015
11,19393,WN,WN,Southwest Airlines Co.,3,157575036,0,0,1215038,1215038,158790074,157803732,1215038,159018770,253423598,0,0,2130843,2130843,255554441,253787047,2130843,255917890,2015
12,21352,0WQ,0WQ,Avjet Corporation,1,0,0,0,0,0,0,150694,27403,178097,0,0,0,0,0,0,388791,80565,469356,2015
12,21645,23Q,23Q,Songbird Airways Inc.,1,0,0,0,0,0,0,0,0,0,0,0,0,0,0,0,0,0,0,2015
12,21652,27Q,27Q,"Jet Aviation Flight Services, Inc.",1,0,0,0,0,0,0,0,0,0,0,0,0,0,0,0,0,0,0,2015
12,20408,5V,5V,Tatonduk Outfitters Limited d/b/a Everts Air Alaska and Everts Air Cargo,1,277726,0,0,0,0,277726,295181,0,295181,593233,0,0,0,0,593233,630517,0,630517,2015
12,19917,5X,5X,United Parcel Service,3,49164000,10609000,18181000,2645000,31435000,80599000,49164000,31435000,80599000,61531000,12565000,24321000,3685000,40571000,102102000,61531000,40571000,102102000,2015
12,20007,5Y,5Y,Atlas Air Inc.,3,0,0,0,0,0,0,7667632,22220580,29888212,0,0,0,0,0,0,13927827,42007330,55935157,2015
12,19874,8C,8C,Air Transport International,2,0,0,0,0,0,0,15834,721597,737431,0,0,0,0,0,0,35086,1963625,1998711,2015
12,20363,9E,9E,Endeavor Air Inc.,2,0,0,0,0,0,0,0,0,0,0,0,0,0,0,0,0,0,0,2015
12,20190,9S,9S,Southern Air Inc.,2,897720,4767619,599707,0,5367326,6265046,897720,5367326,6265046,3249746,17258779,2170938,0,19429717,22679463,3249746,19429717,22679463,2015
12,19805,AA,AA,American Airlines Inc.,3,184631068,41741507,16980073,55010941,113732521,298363589,185221992,113818570,299040562,249562141,49362747,19827111,78972150,148162008,397724149,250305696,148287347,398593043,2015
12,20453,ABX,ABX,ABX Air Inc,2,99353,0,0,0,0,99353,99353,0,99353,216843,0,0,0,0,216843,216843,0,216843,2015
12,19930,AS,AS,Alaska Airlines Inc.,3,37932069,0,0,1215864,1215864,39147933,38023094,1215864,39238958,55713800,0,0,1707995,1707995,57421795,55832431,1707995,57540426,2015
12,20409,B6,B6,JetBlue Airways,3,51366435,0,0,13018170,13018170,64384605,51372975,13084026,64457001,80584469,0,0,20423109,20423109,101007578,80589018,20740604,101329622,2015
12,21167,CP,CP,Compass Airlines,2,0,0,0,0,0,0,0,0,0,0,0,0,0,0,0,0,0,0,2015
12,19790,DL,DL,Delta Air Lines Inc.,3,145140696,54241230,37144139,27211313,118596682,263737378,146441475,118929181,265370656,267495160,99966907,68456867,50150611,218574385,486069545,270719539,219187181,489906720,2015
12,21650,EE,EE,Eastern Airlines Group Inc.,1,0,0,0,0,0,0,99280,191200,290480,0,0,0,0,0,0,176718,340336,517054,2015
12,20366,EV,EV,ExpressJet Airlines Inc.,3,86229,0,0,0,0,86229,86229,0,86229,199039,0,0,0,0,199039,199039,0,199039,2015
12,20436,F9,F9,Frontier Airlines Inc.,3,16303987,0,0,1666578,1666578,17970565,16378898,1670063,18048961,19590011,0,0,2245725,2245725,21835736,19684265,2249905,21934170,2015
12,20107,FX,FX,Federal Express Corporation,3,75751290,10829757,19792571,960542,31582870,107334160,77858396,31912837,109771233,94560000,14372000,28197000,1417000,43986000,138546000,97226000,44561000,141787000,2015
12,20368,G4,G4,Allegiant Air,2,13570705,0,0,0,0,13570705,13948952,0,13948952,20060135,0,0,0,0,20060135,20632487,0,20632487,2015
12,20500,G7,G7,GoJet Airlines LLC d/b/a United Express,2,0,0,0,0,0,0,0,0,0,0,0,0,0,0,0,0,0,0,2015
12,20166,GFQ,GFQ,Gulf And Caribbean Cargo,1,0,0,0,0,0,0,89341,115133,204474,0,0,0,0,0,0,159039,219666,378705,2015
12,20402,GL,GL,Miami Air International,2,0,0,0,0,0,0,393872,147978,541850,0,0,0,0,0,0,856360,321737,1178097,2015
12,19690,HA,HA,Hawaiian Airlines Inc.,3,13928895,0,5934594,0,5934594,19863489,13951058,5944512,19895570,18455251,0,8506274,0,8506274,26961525,18485553,8520111,27005664,2015
12,20310,WL,K8,"Caribbean Sun Airlines, Inc. d/b/a World Atlantic Airlines",1,0,0,0,0,0,0,25985,60135,86120,0,0,0,0,0,0,52659,121864,174523,2015
12,20370,KAQ,KAQ,Kalitta Air LLC,2,0,0,0,0,0,0,2876147,2432259,5308406,0,0,0,0,0,0,3693723,3677667,7371390,2015
12,21629,KD,KD,Western Global,1,0,0,0,0,0,0,33462,0,33462,0,0,0,0,0,0,33462,0,33462,2015
12,21634,KH,KH,Aloha Air Cargo,1,480374,0,0,0,0,480374,480374,0,480374,628542,0,0,0,0,628542,628542,0,628542,2015
12,20372,KLQ,KLQ,Kalitta Charters II,1,0,0,0,0,0,0,130349,51304,181653,0,0,0,0,0,0,246544,92908,339452,2015
12,20151,M6,M6,Amerijet International,2,0,0,0,2040998,2040998,2040998,346075,2101535,2447610,0,0,0,2959846,2959846,2959846,501876,3047636,3549512,2015
12,20398,MQ,MQ,Envoy Air,3,0,0,0,0,0,0,0,0,0,0,0,0,0,0,0,0,0,0,2015
12,20405,N8,MRQ,"National Air Cargo Group, Inc. d/b/a Murray Air",1,25367,0,0,0,0,25367,81997,510784,592781,66972,0,0,0,0,66972,159145,1119334,1278479,2015
12,20108,NC,NC,Northern Air Cargo Inc.,1,317594,0,0,0,0,317594,503123,5747,508870,503299,0,0,0,0,503299,842901,10856,853757,2015
12,20416,NK,NK,Spirit Air Lines,3,20381493,0,0,2065085,2065085,22446578,20381493,2065085,22446578,30942341,0,0,3135127,3135127,34077468,30942341,3135127,34077468,2015
12,20397,OH,OH,PSA Airlines Inc.,2,0,0,0,0,0,0,0,0,0,0,0,0,0,0,0,0,0,0,2015
12,20304,OO,OO,SkyWest Airlines Inc.,3,5240799,0,0,0,0,5240799,5240799,0,5240799,8346965,0,0,0,0,8346965,8346965,0,8346965,2015
12,20177,PFQ,PFQ,Asia Pacific,1,0,0,0,0,0,0,0,358415,358415,0,0,0,0,0,0,0,743248,743248,2015
12,20100,PO,PO,Polar Air Cargo Airways,3,3067994,725179,13264324,0,13989503,17057497,3067994,13989503,17057497,4303972,1218574,18582691,0,19801265,24105237,4303972,19801265,24105237,2015
12,20149,PRQ,PRQ,Florida West Airlines Inc.,1,0,0,0,0,0,0,0,0,0,0,0,0,0,0,0,0,0,0,2015
12,19687,QX,QX,Horizon Air,2,0,0,0,0,0,0,0,0,0,0,0,0,0,0,0,0,0,0,2015
12,20448,S5,S5,Shuttle America Corp.,2,4704440,0,0,0,0,4704440,4704440,0,4704440,5651606,0,0,0,0,5651606,5651606,0,5651606,2015
12,20422,SY,SY,Sun Country Airlines d/b/a MN Airlines,2,3560211,0,0,836852,836852,4397063,3852205,880029,4732234,4939007,0,0,1188208,1188208,6127215,5709119,1250631,6959750,2015
12,20447,U7,U7,USA Jet Airlines Inc.,2,0,0,0,0,0,0,374394,25199,399593,0,0,0,0,0,0,507476,52464,559940,2015
12,19977,UA,UA,United Air Lines Inc.,3,122308960,53581299,54721944,31718063,140021306,262330266,123443388,140503719,263947107,156201112,73221395,76650715,43865937,193738047,349939159,159379401,194425738,353805139,2015
12,21171,VX,VX,Virgin America,3,14983004,0,0,205304,205304,15188308,15147453,205304,15352757,18510642,0,0,286616,286616,18797258,18730226,286616,19016842,2015
12,20308,WE,WE,Centurion Cargo Inc.,2,0,0,0,0,0,0,186690,364077,550767,0,0,0,0,0,0,0,551553,551553,2015
12,20195,WI,WI,Sky Lease Cargo,1,0,0,0,0,0,0,0,0,0,0,0,0,0,0,0,0,0,0,2015
12,20287,WP,WP,Island Air Hawaii,1,101145,0,0,0,0,101145,101145,0,101145,153796,0,0,0,0,153796,153796,0,153796,2015
12,20377,X9,X9,Omni Air Express,2,0,0,0,0,0,0,380850,1385676,1766526,0,0,0,0,0,0,544222,3485569,4029791,2015
12,20207,XP,XP,XTRA Airways,1,0,0,0,0,0,0,298258,191366,489624,0,0,0,0,0,0,617394,396128,1013522,2015
12,20378,YV,YV,Mesa Airlines Inc.,2,0,0,0,0,0,0,0,0,0,0,0,0,0,0,0,0,0,0,2015
12,20452,YX,YX,Republic Airlines,2,12998931,0,0,0,0,12998931,12998931,0,12998931,17277275,0,0,0,0,17277275,17277275,0,17277275,2015
12,20046,ZW,ZW,Air Wisconsin Airlines Corp,2,6573348,0,0,0,0,6573348,6573348,0,6573348,9810113,0,0,0,0,9810113,9810113,0,9810113,2015
12,19393,WN,WN,Southwest Airlines Co.,3,162227806,0,0,1532998,1532998,163760804,162453223,1532998,163986221,236813117,0,0,2409496,2409496,239222613,237139315,2409496,239548811,2015
1,21161,09Q,09Q,"Swift Air, LLC d/b/a Eastern Air Lines d/b/a Eastern",2,0,0,0,0,0,0,581221,653989,1235210,0,0,0,0,0,0,1831212,1618745,3449957,2019
1,21352,0WQ,0WQ,Avjet Corporation,1,0,0,0,0,0,0,0,0,0,0,0,0,0,0,0,0,0,0,2019
1,21492,1BQ,1BQ,"Eastern Airlines f/k/a Dynamic Airways, LLC",1,0,0,0,0,0,0,35325,25496,60821,0,0,0,0,0,0,102795,74193,176988,2019
1,21652,27Q,27Q,"Jet Aviation Flight Services, Inc.",1,0,0,0,0,0,0,0,0,0,0,0,0,0,0,0,0,0,0,2019
1,21712,2HQ,2HQ,Elite Airways LLC,1,66815,0,0,0,0,66815,410186,0,410186,175499,0,0,0,0,175499,1518919,0,1518919,2019
1,21974,3EQ,3EQ,"Scott Aviation, LLC  d/b/a  Silver Air",1,0,0,0,0,0,0,0,0,0,0,0,0,0,0,0,0,0,0,2019
1,20408,5V,5V,Tatonduk Outfitters Limited d/b/a Everts Air Alaska and Everts Air Cargo,1,287034,0,0,0,0,287034,304851,0,304851,746126,0,0,0,0,746126,792440,0,792440,2019
1,19917,5X,5X,United Parcel Service,3,41673000,12332000,16238000,2967000,31537000,73210000,41673000,31537000,73210000,75938000,22394000,29385000,5845000,57624000,133562000,75938000,57624000,133562000,2019
1,20007,5Y,5Y,Atlas Air Inc.,3,0,0,0,0,0,0,14285985,30124140,44410125,0,0,0,0,0,0,30473337,61310144,91783481,2019
1,19874,8C,8C,Air Transport International,2,0,0,0,0,0,0,23622,742229,765851,0,0,0,0,0,0,43613,1910733,1954346,2019
1,20363,9E,9E,Endeavor Air Inc.,2,0,0,0,0,0,0,0,0,0,0,0,0,0,0,0,0,0,0,2019
1,20190,9S,9S,Southern Air Inc.,2,879987,2095479,3874541,0,5970020,6850007,879987,5970020,6850007,1839813,4762196,7207014,0,11969210,13809023,1839813,11969210,13809023,2019
1,19805,AA,AA,American Airlines Inc.,3,181805365,35379724,19744574,48979198,104103496,285908861,182280559,104264171,286544730,330993694,65177657,36092606,94494528,195764791,526758485,331867432,196062834,527930266,2019
1,20453,ABX,ABX,ABX Air Inc,2,229897,0,0,0,0,229897,229897,0,229897,443700,0,0,0,0,443700,443700,0,443700,2019
1,19930,AS,AS,Alaska Airlines Inc.,3,55801380,0,0,1202557,1202557,57003937,55881608,1202557,57084165,114278887,0,0,2867163,2867163,117146050,114428031,2867163,117295194,2019
1,20409,B6,B6,JetBlue Airways,3,55214112,0,0,15194099,15194099,70408211,55214112,15194099,70408211,107587447,0,0,29606459,29606459,137193906,107587447,29606459,137193906,2019
1,21167,CP,CP,Compass Airlines,2,0,0,0,0,0,0,0,0,0,0,0,0,0,0,0,0,0,0,2019
1,19790,DL,DL,Delta Air Lines Inc.,3,165835898,48129821,28376721,29135082,105641624,271477522,167883633,105823230,273706863,340011832,98680134,58180533,59735394,216596061,556607893,345424031,216968407,562392438,2019
1,20366,EV,EV,ExpressJet Airlines Inc.,2,0,0,0,0,0,0,0,0,0,0,0,0,0,0,0,0,0,0,2019
1,20436,F9,F9,Frontier Airlines Inc.,3,19219538,0,0,2622943,2622943,21842481,19219538,2622943,21842481,33033803,0,0,4629668,4629668,37663471,33033803,4629668,37663471,2019
1,20107,FX,FX,Federal Express Corporation,3,61502329,14334224,21909780,1984964,38228968,99731297,63304927,39128919,102433846,111194000,26208000,39844000,4174000,70226000,181420000,114483000,72218000,186701000,2019
1,20368,G4,G4,Allegiant Air,3,12442727,0,0,0,0,12442727,12704100,79969,12784069,24884405,0,0,0,0,24884405,25451228,174212,25625440,2019
1,20500,G7,G7,GoJet Airlines LLC d/b/a United Express,2,0,0,0,0,0,0,0,0,0,0,0,0,0,0,0,0,0,0,2019
1,20166,GFQ,GFQ,Gulf And Caribbean Cargo,1,0,0,0,0,0,0,209031,149862,358893,0,0,0,0,0,0,525709,384656,910365,2019
1,20402,GL,GL,Miami Air International,2,0,0,0,0,0,0,471431,148428,619859,0,0,0,0,0,0,1315825,414285,1730110,2019
1,19690,HA,HA,Hawaiian Airlines Inc.,3,15257659,0,7346463,0,7346463,22604122,15280124,7346463,22626587,27092396,0,12857142,0,12857142,39949538,27129872,12857142,39987014,2019
1,20370,KAQ,KAQ,Kalitta Air LLC,2,0,0,0,0,0,0,1444216,3970232,5414448,0,0,0,0,0,0,3030143,9034418,12064561,2019
1,21629,KD,KD,Western Global,2,0,0,0,0,0,0,1404278,1361512,2765790,0,0,0,0,0,0,2693455,1751966,4445421,2019
1,21634,KH,KH,Aloha Air Cargo,2,432202,0,0,0,0,432202,432202,0,432202,863451,0,0,0,0,863451,863451,0,863451,2019
1,20372,KLQ,KLQ,Kalitta Charters II,1,0,0,0,0,0,0,67948,124783,192731,0,0,0,0,0,0,192105,348416,540521,2019
1,20169,L2,L2,Lynden Air Cargo Airlines,1,96124,0,0,0,0,96124,174531,25265,199796,209803,0,0,0,0,209803,425821,75490,501311,2019
1,20151,M6,M6,Amerijet International,2,0,0,0,995280,995280,995280,513000,1259892,1772892,0,0,0,1985393,1985393,1985393,1023337,2513244,3536581,2019
1,20398,MQ,MQ,Envoy Air,3,0,0,0,0,0,0,0,0,0,0,0,0,0,0,0,0,0,0,2019
1,20405,N8,N8,National Air Cargo Group Inc d/ba National Airlines,2,0,0,0,0,0,0,67058,730951,798009,0,0,0,0,0,0,225990,2182806,2408796,2019
1,20108,NC,NC,Northern Air Cargo Inc.,1,336228,0,0,0,0,336228,388494,0,388494,661891,0,0,0,0,661891,762275,0,762275,2019
1,20416,NK,NK,Spirit Air Lines,3,31236251,0,0,4626264,4626264,35862515,31236251,4626264,35862515,62051998,0,0,9190250,9190250,71242248,62051998,9190250,71242248,2019
1,20397,OH,OH,PSA Airlines Inc.,2,0,0,0,0,0,0,0,0,0,0,0,0,0,0,0,0,0,0,2019
1,20304,OO,OO,SkyWest Airlines Inc.,3,8150037,0,0,0,0,8150037,8150037,0,8150037,17779528,0,0,0,0,17779528,17779528,0,17779528,2019
1,20177,PFQ,PFQ,Asia Pacific,1,0,0,0,0,0,0,0,330575,330575,0,0,0,0,0,0,0,640575,640575,2019
1,20100,PO,PO,Polar Air Cargo Airways,3,3095682,731689,13380503,0,14112192,17207874,3095682,14112192,17207874,5600244,1626373,22917040,0,24543413,30143657,5600244,24543413,30143657,2019
1,19687,QX,QX,Horizon Air,2,0,0,0,0,0,0,0,0,0,0,0,0,0,0,0,0,0,0,2019
1,20422,SY,SY,Sun Country Airlines d/b/a MN Airlines,2,3603825,0,0,1228302,1228302,4832127,4116225,1344257,,7127230,0,0,2630245,2630245,9757475,9034510,2861737,11896247,2019
1,20447,U7,U7,USA Jet Airlines Inc.,2,0,0,0,0,0,0,467799,39870,507669,0,0,0,0,0,0,860549,167956,1028505,2019
1,19977,UA,UA,United Air Lines Inc.,3,127590604,53538012,55192482,32518620,141249114,268839718,128594032,141518914,270112946,234726719,98041019,102255125,63335233,263631377,498358096,236590640,264119815,500710455,2019
1,20195,WI,WI,Sky Lease Cargo,2,0,0,0,0,0,0,0,1329432,1329432,0,0,0,0,0,0,0,2664398,2664398,2019
1,20310,WL,WL,"Caribbean Sun Airlines, Inc. d/b/a World Atlantic Airlines",1,0,0,0,0,0,0,47941,0,47941,0,0,0,0,0,0,141256,0,141256,2019
1,20377,X9,X9,Omni Air International LLC,2,0,0,0,0,0,0,431442,3654782,4086224,0,0,0,0,0,0,905436,10495937,11401373,2019
1,20207,XP,XP,XTRA Airways,1,0,0,0,0,0,0,2501,0,2501,0,0,0,0,0,0,8341,0,8341,2019
1,20378,YV,YV,Mesa Airlines Inc.,2,0,0,0,0,0,0,0,0,0,0,0,0,0,0,0,0,0,0,2019
1,20452,YX,YX,Republic Airline,3,20121,0,0,0,0,20121,20121,0,20121,43183,0,0,0,0,43183,43183,0,43183,2019
1,19393,WN,WN,Southwest Airlines Co.,3,162877133,0,0,1789759,1789759,164666892,163091949,1789759,164881708,311257985,0,0,4071037,4071037,315329022,311660539,4071037,315731576,2019
2,21161,09Q,09Q,"Swift Air, LLC d/b/a Eastern Air Lines d/b/a Eastern",2,0,0,0,0,0,0,473629,703692,1177321,0,0,0,0,0,0,1719142,1330481,3049623,2019
2,21352,0WQ,0WQ,Avjet Corporation,1,0,0,0,0,0,0,0,0,0,0,0,0,0,0,0,0,0,0,2019
2,21492,1BQ,1BQ,"Eastern Airlines f/k/a Dynamic Airways, LLC",1,0,0,0,0,0,0,10306,10838,21144,0,0,0,0,0,0,28651,30130,58781,2019
2,21652,27Q,27Q,"Jet Aviation Flight Services, Inc.",1,0,0,0,0,0,0,0,0,0,0,0,0,0,0,0,0,0,0,2019
2,21712,2HQ,2HQ,Elite Airways LLC,1,56789,0,0,0,0,56789,380855,0,380855,166382,0,0,0,0,166382,1485395,0,1485395,2019
2,21974,3EQ,3EQ,"Scott Aviation, LLC  d/b/a  Silver Air",1,0,0,0,0,0,0,0,0,0,0,0,0,0,0,0,0,0,0,2019
2,20408,5V,5V,Tatonduk Outfitters Limited d/b/a Everts Air Alaska and Everts Air Cargo,1,232268,0,0,0,0,232268,274605,0,274605,636845,0,0,0,0,636845,752926,0,752926,2019
2,19917,5X,5X,United Parcel Service,3,37155000,10576000,10951000,2930000,24457000,61612000,37155000,24457000,61612000,72268000,20252000,20399000,6093000,46744000,119012000,72268000,46744000,119012000,2019
2,20007,5Y,5Y,Atlas Air Inc.,3,0,0,0,0,0,0,5925931,31971559,37897490,0,0,0,0,0,0,13017193,65417799,78434992,2019
2,19874,8C,8C,Air Transport International,2,0,0,0,0,0,0,10945,668700,679645,0,0,0,0,0,0,31288,1749284,1780572,2019
2,20363,9E,9E,Endeavor Air Inc.,2,0,0,0,0,0,0,0,0,0,0,0,0,0,0,0,0,0,0,2019
2,20190,9S,9S,Southern Air Inc.,2,766074,2306492,3084112,2433,5393037,6159111,766074,5393037,6159111,1630575,4868978,6396131,4423,11269532,12900107,1630575,11269532,12900107,2019
2,19805,AA,AA,American Airlines Inc.,3,171404503,30958800,17322712,44034884,92316396,263720899,171809048,92477489,264286537,327026752,59435663,32573780,86843048,178852491,505879243,327810856,179178991,506989847,2019
2,20453,ABX,ABX,ABX Air Inc,2,147714,0,0,0,0,147714,147714,0,147714,0,0,0,0,0,0,0,0,0,2019
2,19930,AS,AS,Alaska Airlines Inc.,3,50051046,0,0,1189785,1189785,51240831,50121660,1189785,51311445,107264474,0,0,3017190,3017190,110281664,107399929,3017190,110417119,2019
2,20409,B6,B6,JetBlue Airways,3,52642699,0,0,13782584,13782584,66425283,52645386,13782584,66427970,108554374,0,0,28421031,28421031,136975405,108559925,28421031,136980956,2019
2,21167,CP,CP,Compass Airlines,2,0,0,0,0,0,0,0,0,0,0,0,0,0,0,0,0,0,0,2019
2,19790,DL,DL,Delta Air Lines Inc.,3,152322966,42273867,24710323,26290073,93274263,245597229,154407088,93667362,248074450,313961048,87132937,50931775,54187883,192252595,506213643,319361813,193062831,512424644,2019
2,20436,F9,F9,Frontier Airlines Inc.,3,17536368,0,0,2546226,2546226,20082594,17536368,2546226,20082594,34472192,0,0,4986355,4986355,39458547,34472192,4986355,39458547,2019
2,20107,FX,FX,Federal Express Corporation,3,55621824,13088387,18142095,1814495,33044977,88666801,57413610,33859713,91273323,107603000,25317000,34071000,4001000,63389000,170992000,111096633,65173000,176269633,2019
2,20368,G4,G4,Allegiant Air,3,13512627,0,0,0,0,13512627,13869284,121194,13990478,29175127,0,0,0,0,29175127,30035295,292448,30327743,2019
2,20500,G7,G7,GoJet Airlines LLC d/b/a United Express,2,0,0,0,0,0,0,0,0,0,0,0,0,0,0,0,0,0,0,2019
2,20166,GFQ,GFQ,Gulf And Caribbean Cargo,1,0,0,0,0,0,0,243903,82869,326772,0,0,0,0,0,0,635761,229579,865340,2019
2,20402,GL,GL,Miami Air International,2,0,0,0,0,0,0,480858,242533,723391,0,0,0,0,0,0,1399624,705936,2105560,2019
2,19690,HA,HA,Hawaiian Airlines Inc.,3,13532765,0,6418283,0,6418283,19951048,13532765,6418283,19951048,25862219,0,11806211,0,11806211,37668430,25862219,11806211,37668430,2019
2,20370,KAQ,KAQ,Kalitta Air LLC,2,0,0,0,0,0,0,1728042,3983371,5711413,0,0,0,0,0,0,3866084,9664349,13530433,2019
2,21629,KD,KD,Western Global,2,0,0,0,0,0,0,1579656,682988,2262644,0,0,0,0,0,0,3364687,1439034,4803721,2019
2,21634,KH,KH,Aloha Air Cargo,2,338518,0,0,0,0,338518,338518,0,338518,635575,0,0,0,0,635575,635575,0,635575,2019
2,20372,KLQ,KLQ,Kalitta Charters II,1,0,0,0,0,0,0,182000,33582,215582,0,0,0,0,0,0,461211,91078,552289,2019
2,20169,L2,L2,Lynden Air Cargo Airlines,1,88275,0,0,0,0,88275,119324,9368,128692,209784,0,0,0,0,209784,293751,22492,316243,2019
2,20151,M6,M6,Amerijet International,2,0,0,0,1273169,1273169,1273169,494687,1368318,1863005,0,0,0,2717366,2717366,2717366,1055826,2920446,3976272,2019
2,20398,MQ,MQ,Envoy Air,3,0,0,0,0,0,0,0,0,0,0,0,0,0,0,0,0,0,0,2019
2,20405,N8,N8,National Air Cargo Group Inc d/ba National Airlines,2,0,0,0,0,0,0,45744,258810,304554,0,0,0,0,0,0,160755,2701263,2862018,2019
2,20108,NC,NC,Northern Air Cargo Inc.,1,255741,0,0,0,0,255741,282780,0,282780,550182,0,0,0,0,550182,602185,0,602185,2019
2,20416,NK,NK,Spirit Air Lines,3,29560076,0,0,4030920,4030920,33590996,29560076,4030920,33590996,62838607,0,0,8568901,8568901,71407508,62838607,8568901,71407508,2019
2,20397,OH,OH,PSA Airlines Inc.,2,0,0,0,0,0,0,0,0,0,0,0,0,0,0,0,0,0,0,2019
2,20304,OO,OO,SkyWest Airlines Inc.,3,7503491,0,0,0,0,7503491,7503491,0,7503491,17050445,0,0,0,0,17050445,17050445,0,17050445,2019
2,20177,PFQ,PFQ,Asia Pacific,1,0,0,0,0,0,0,0,355981,355981,0,0,0,0,0,0,0,735012,735012,2019
2,20100,PO,PO,Polar Air Cargo Airways,3,2080351,470893,9936241,0,10407134,12487485,2080351,10407134,12487485,4008576,1039859,17494774,0,18534633,22543209,4008576,18534633,22543209,2019
2,19687,QX,QX,Horizon Air,2,0,0,0,0,0,0,0,0,0,0,0,0,0,0,0,0,0,0,2019
2,20422,SY,SY,Sun Country Airlines d/b/a MN Airlines,2,3730042,0,0,1725278,1725278,5455320,4229974,1836456,6066430,8041181,0,0,4024835,4024835,12066016,9890673,4266112,14156785,2019
2,20447,U7,U7,USA Jet Airlines Inc.,2,0,0,0,0,0,0,482752,32144,514896,0,0,0,0,0,0,952822,134969,1087791,2019
2,19977,UA,UA,United Air Lines Inc.,3,119312158,47970572,47881165,28457222,124308959,243621117,120087215,124665157,244752372,229838806,91564050,91129457,58249915,240943422,470782228,231327828,241611991,472939819,2019
2,20195,WI,WI,Sky Lease Cargo,2,0,0,0,0,0,0,0,982250,982250,0,0,0,0,0,0,0,2064254,2064254,2019
2,20310,WL,WL,"Caribbean Sun Airlines, Inc. d/b/a World Atlantic Airlines",1,0,0,0,0,0,0,26298,0,26298,0,0,0,0,0,0,69192,0,69192,2019
2,20377,X9,X9,Omni Air International LLC,2,0,0,0,0,0,0,370322,3235578,3605900,0,0,0,0,0,0,824611,8179604,9004215,2019
2,20207,XP,XP,XTRA Airways,1,0,0,0,0,0,0,2851,0,2851,0,0,0,0,0,0,9832,0,9832,2019
2,20378,YV,YV,Mesa Airlines Inc.,2,0,0,0,0,0,0,0,0,0,0,0,0,0,0,0,0,0,0,2019
2,20452,YX,YX,Republic Airline,3,41318,0,0,0,0,41318,41318,0,41318,85698,0,0,0,0,85698,85698,0,85698,2019
2,19393,WN,WN,Southwest Airlines Co.,3,146808596,0,0,1759751,1759751,148568347,146910807,1759751,148670558,289139878,0,0,4222874,4222874,293362752,289336674,4222874,293559548,2019
3,21161,09Q,09Q,"Swift Air, LLC d/b/a Eastern Air Lines d/b/a Eastern",2,0,0,0,0,0,0,796100,626848,1422948,0,0,0,0,0,0,2721022,1852717,4573739,2019
3,21352,0WQ,0WQ,Avjet Corporation,1,0,0,0,0,0,0,0,0,0,0,0,0,0,0,0,0,0,0,2019
3,21492,1BQ,1BQ,"Eastern Airlines f/k/a Dynamic Airways, LLC",1,0,0,0,0,0,0,7775,19521,27296,0,0,0,0,0,0,17961,45093,63054,2019
3,21652,27Q,27Q,"Jet Aviation Flight Services, Inc.",1,0,0,0,0,0,0,0,0,0,0,0,0,0,0,0,0,0,0,2019
3,21712,2HQ,2HQ,Elite Airways LLC,1,72228,0,0,0,0,72228,380854,0,380854,197885,0,0,0,0,197885,1466979,0,1466979,2019
3,21974,3EQ,3EQ,"Scott Aviation, LLC  d/b/a  Silver Air",1,0,0,0,0,0,0,0,0,0,0,0,0,0,0,0,0,0,0,2019
3,20408,5V,5V,Tatonduk Outfitters Limited d/b/a Everts Air Alaska and Everts Air Cargo,1,313346,0,0,0,0,313346,375331,0,375331,901770,0,0,0,0,901770,1080156,0,1080156,2019
3,19917,5X,5X,United Parcel Service,3,39076000,11813000,16555000,2772000,31140000,70216000,39076000,31140000,70216000,78171000,23391000,32977000,5885000,62253000,140424000,78171000,62253000,140424000,2019
3,20007,5Y,5Y,Atlas Air Inc.,3,0,0,0,0,0,0,15305509,35370667,50676176,0,0,0,0,0,0,33606169,80421617,114027786,2019
3,19874,8C,8C,Air Transport International,2,0,0,0,0,0,0,9158,693883,703041,0,0,0,0,0,0,26141,1602941,1629082,2019
3,20363,9E,9E,Endeavor Air Inc.,2,0,0,0,0,0,0,0,0,0,0,0,0,0,0,0,0,0,0,2019
3,20190,9S,9S,Southern Air Inc.,2,1132125,2270891,4202599,11610,6485100,7617225,1132125,6485100,7617225,2452661,5438549,9316333,23597,14778479,17231140,2452661,14778479,17231140,2019
3,19805,AA,AA,American Airlines Inc.,3,193300520,39602165,18989484,49281517,107873166,301173686,193844696,108126311,301971007,377335558,78539440,37331130,100988984,216859554,594195112,378410499,217383476,595793975,2019
3,20453,ABX,ABX,ABX Air Inc,2,134567,0,0,0,0,134567,134567,0,134567,0,0,0,0,0,0,0,0,0,2019
3,19930,AS,AS,Alaska Airlines Inc.,3,59205964,0,0,1342907,1342907,60548871,59266999,1342907,60609906,131021319,0,0,3487341,3487341,134508660,131141759,3487341,134629100,2019
3,20409,B6,B6,JetBlue Airways,3,60110558,0,0,16281212,16281212,76391770,60118439,16281212,76399651,128192313,0,0,34721459,34721459,162913772,128209025,34721459,162930484,2019
3,21167,CP,CP,Compass Airlines,2,0,0,0,0,0,0,0,0,0,0,0,0,0,0,0,0,0,0,2019
3,19790,DL,DL,Delta Air Lines Inc.,3,187116451,51208157,29039222,29626719,109874098,296990549,189695114,110256891,299952005,379215596,103779928,58851724,60042363,222674015,601889611,385807332,223449795,609257127,2019
3,20366,EV,EV,ExpressJet Airlines Inc.,2,0,0,0,0,0,0,0,0,0,0,0,0,0,0,0,0,0,0,2019
3,20436,F9,F9,Frontier Airlines Inc.,3,19844056,0,0,2296146,2296146,22140202,19844056,2296146,22140202,38296243,0,0,4598255,4598255,42894498,38296243,4598255,42894498,2019
3,20107,FX,FX,Federal Express Corporation,3,59597384,14946076,21935646,1954871,38836593,98433977,61495565,39837097,101332662,117707000,29910000,43924000,4462000,78296000,196003000,121522000,80634514,202156514,2019
3,20368,G4,G4,Allegiant Air,3,19112504,0,0,0,0,19112504,19457496,241511,19699007,42155397,0,0,0,0,42155397,42946254,573890,43520144,2019
3,20500,G7,G7,GoJet Airlines LLC d/b/a United Express,2,0,0,0,0,0,0,0,0,0,0,0,0,0,0,0,0,0,0,2019
3,20166,GFQ,GFQ,Gulf And Caribbean Cargo,1,0,0,0,0,0,0,271265,118131,389396,0,0,0,0,0,0,707757,328423,1036180,2019
3,20402,GL,GL,Miami Air International,2,0,0,0,0,0,0,535031,409667,944698,0,0,0,0,0,0,1510093,1156258,2666351,2019
3,19690,HA,HA,Hawaiian Airlines Inc.,3,15074904,0,6868252,0,6868252,21943156,15074904,6868252,21943156,29926149,0,13490935,0,13490935,43417084,29926149,13490935,43417084,2019
3,20370,KAQ,KAQ,Kalitta Air LLC,2,0,0,0,0,0,0,2850738,4086355,6937093,0,0,0,0,0,0,6114511,10033932,16148443,2019
3,21629,KD,KD,Western Global,2,0,0,0,0,0,0,1757258,1498463,3255721,0,0,0,0,0,0,3799780,1891764,5691544,2019
3,21634,KH,KH,Aloha Air Cargo,2,388491,0,0,0,0,388491,388491,0,388491,770139,0,0,0,0,770139,770139,0,770139,2019
3,20372,KLQ,KLQ,Kalitta Charters II,1,0,0,0,0,0,0,353642,5761,359403,0,0,0,0,0,0,895857,14948,910805,2019
3,20169,L2,L2,Lynden Air Cargo Airlines,1,101751,0,0,0,0,101751,186550,0,186550,249880,0,0,0,0,249880,487617,0,487617,2019
3,20151,M6,M6,Amerijet International,2,0,0,0,1542592,1542592,1542592,571030,1757801,2328831,0,0,0,3380082,3380082,3380082,1251224,3851642,5102866,2019
3,20398,MQ,MQ,Envoy Air,3,0,0,0,0,0,0,0,0,0,0,0,0,0,0,0,0,0,0,2019
3,20405,N8,N8,National Air Cargo Group Inc d/ba National Airlines,2,0,0,0,0,0,0,108920,1025984,1134904,0,0,0,0,0,0,413110,3086189,3499299,2019
3,20108,NC,NC,Northern Air Cargo Inc.,1,279333,0,0,0,0,279333,328645,0,328645,613337,0,0,0,0,613337,723951,0,723951,2019
3,20416,NK,NK,Spirit Air Lines,3,35893084,0,0,4481589,4481589,40374673,35893084,4481589,40374673,77330846,0,0,9655482,9655482,86986328,77330846,9655482,86986328,2019
3,20397,OH,OH,PSA Airlines Inc.,2,0,0,0,0,0,0,0,0,0,0,0,0,0,0,0,0,0,0,2019
3,20304,OO,OO,SkyWest Airlines Inc.,3,8558824,0,0,0,0,8558824,8558824,0,8558824,20654129,0,0,0,0,20654129,20654129,0,20654129,2019
3,20177,PFQ,PFQ,Asia Pacific,1,0,0,0,0,0,0,0,368456,368456,0,0,0,0,0,0,0,856040,856040,2019
3,20100,PO,PO,Polar Air Cargo Airways,3,2855050,746847,12632848,0,13379695,16234745,2855050,13379695,16234745,5715144,1638605,23950550,0,25589155,31304299,5715144,25589155,31304299,2019
3,19687,QX,QX,Horizon Air,2,0,0,0,0,0,0,0,0,0,0,0,0,0,0,0,0,0,0,2019
3,20422,SY,SY,Sun Country Airlines d/b/a MN Airlines,2,4298659,0,0,2346265,2346265,6644924,5031559,2401549,7433108,9450123,0,0,5577475,5577475,15027598,12628918,5712762,18341680,2019
3,20447,U7,U7,USA Jet Airlines Inc.,2,0,0,0,0,0,0,740889,45376,786265,0,0,0,0,0,0,1496040,157033,1653073,2019
3,19977,UA,UA,United Air Lines Inc.,3,147713026,59512296,55608646,34000681,149121623,296834649,148464310,149383772,297848082,293660063,118095979,111813272,72117501,302026752,595686815,295178703,302550240,597728943,2019
3,20195,WI,WI,Sky Lease Cargo,2,0,0,0,0,0,0,0,1343397,1343397,0,0,0,0,0,0,0,2932536,2932536,2019
3,20310,WL,WL,"Caribbean Sun Airlines, Inc. d/b/a World Atlantic Airlines",1,0,0,0,0,0,0,54955,4135,59090,0,0,0,0,0,0,124385,9359,133744,2019
3,20377,X9,X9,Omni Air International LLC,2,0,0,0,0,0,0,546781,3383937,3930718,0,0,0,0,0,0,1419862,6522442,7942304,2019
3,20207,XP,XP,XTRA Airways,1,0,0,0,0,0,0,0,0,0,0,0,0,0,0,0,0,0,0,2019
3,20378,YV,YV,Mesa Airlines Inc.,2,0,0,0,0,0,0,0,0,0,0,0,0,0,0,0,0,0,0,2019
3,20452,YX,YX,Republic Airline,3,13935,0,0,0,0,13935,13935,0,13935,29768,0,0,0,0,29768,29768,0,29768,2019
3,19393,WN,WN,Southwest Airlines Co.,3,177681157,0,0,2488121,2488121,180169278,177789535,2488121,180277656,352911927,0,0,6073530,6073530,358985457,353137046,6073530,359210576,2019
4,21161,09Q,09Q,"Swift Air, LLC d/b/a Eastern Air Lines d/b/a Eastern",2,0,0,0,0,0,0,438847,573413,1012260,0,0,0,0,0,0,1519482,1110701,2630183,2019
4,21352,0WQ,0WQ,Avjet Corporation,1,0,0,0,0,0,0,0,0,0,0,0,0,0,0,0,0,0,0,2019
4,21492,1BQ,1BQ,"Eastern Airlines f/k/a Dynamic Airways, LLC",1,0,0,0,0,0,0,1458,33138,34596,0,0,0,0,0,0,7463,80526,87989,2019
4,21652,27Q,27Q,"Jet Aviation Flight Services, Inc.",1,0,0,0,0,0,0,0,0,0,0,0,0,0,0,0,0,0,0,2019
4,21712,2HQ,2HQ,Elite Airways LLC,1,108171,0,0,0,0,108171,257621,0,257621,292609,0,0,0,0,292609,890987,0,890987,2019
4,21974,3EQ,3EQ,"Scott Aviation, LLC  d/b/a  Silver Air",1,0,0,0,0,0,0,0,0,0,0,0,0,0,0,0,0,0,0,2019
4,20408,5V,5V,Tatonduk Outfitters Limited d/b/a Everts Air Alaska and Everts Air Cargo,1,293620,0,0,0,0,293620,333350,0,333350,821935,0,0,0,0,821935,933152,0,933152,2019
4,19917,5X,5X,United Parcel Service,3,40908000,11964000,16915000,3034000,31913000,72821000,40908000,31913000,72821000,84149000,23994000,34569000,6530000,65093000,149242000,84149000,65093000,149242000,2019
4,20007,5Y,5Y,Atlas Air Inc.,3,0,0,0,0,0,0,15865672,34294456,50160128,0,0,0,0,0,0,35939769,74764973,110704742,2019
4,19874,8C,8C,Air Transport International,2,0,0,0,0,0,0,313624,782826,1096450,0,0,0,0,0,0,38574,2020064,2058638,2019
4,20363,9E,9E,Endeavor Air Inc.,2,0,0,0,0,0,0,0,0,0,0,0,0,0,0,0,0,0,0,2019
4,20190,9S,9S,Southern Air Inc.,2,992362,2232567,4241516,0,6474083,7466445,992362,6474083,7466445,2221720,5212881,9035414,0,14248295,16470015,2221720,14248295,16470015,2019
4,19805,AA,AA,American Airlines Inc.,3,180184898,49277957,18132384,42916293,110326634,290511532,180567823,110440799,291008622,362560543,99573979,36677163,90155938,226407080,588967623,363320993,226648425,589969418,2019
4,20453,ABX,ABX,ABX Air Inc,2,194952,0,0,0,0,194952,194952,0,194952,0,0,0,0,0,0,0,0,0,2019
4,19930,AS,AS,Alaska Airlines Inc.,3,58372355,0,0,1293697,1293697,59666052,58432767,1293697,59726464,133673299,0,0,3411283,3411283,137084582,133797164,3411283,137208447,2019
4,20409,B6,B6,JetBlue Airways,3,59527739,0,0,15649373,15649373,75177112,59527739,15649373,75177112,128724788,0,0,33840732,33840732,162565520,128724788,33840732,162565520,2019
4,21167,CP,CP,Compass Airlines,2,0,0,0,0,0,0,0,0,0,0,0,0,0,0,0,0,0,0,2019
4,19790,DL,DL,Delta Air Lines Inc.,3,178154335,62537834,29643566,23576826,115758226,293912561,180070679,116040467,296111146,359449469,126178189,59809739,47569302,233557230,593006699,364498097,234126688,598624785,2019
4,20366,EV,EV,ExpressJet Airlines LLC,2,0,0,0,0,0,0,0,0,0,0,0,0,0,0,0,0,0,0,2019
4,20436,F9,F9,Frontier Airlines Inc.,3,19681831,0,0,1940677,1940677,21622508,19681831,1940677,21622508,38668884,0,0,4094706,4094706,42763590,38668884,4094706,42763590,2019
4,20107,FX,FX,Federal Express Corporation,3,56512179,15119466,22179883,1844567,39143916,95656095,58066815,39768042,97834857,114638000,30061000,44806000,4252000,79119000,193757000,117835000,80518000,198353000,2019
4,20368,G4,G4,Allegiant Air,3,16794117,0,0,0,0,16794117,17181795,207518,17389313,37653594,0,0,0,0,37653594,38555060,483463,39038523,2019
4,20500,G7,G7,GoJet Airlines LLC d/b/a United Express,2,0,0,0,0,0,0,0,0,0,0,0,0,0,0,0,0,0,0,2019
4,20166,GFQ,GFQ,Gulf And Caribbean Cargo,1,0,0,0,0,0,0,120666,124444,245110,0,0,0,0,0,0,307987,342835,650822,2019
4,20402,GL,GL,Miami Air International,2,0,0,0,0,0,0,200346,315308,515654,0,0,0,0,0,0,546281,859747,1406028,2019
4,19690,HA,HA,Hawaiian Airlines Inc.,3,15343204,0,6690692,0,6690692,22033896,15343204,6690692,22033896,31430036,0,13400043,0,13400043,44830079,31430036,13400043,44830079,2019
4,20370,KAQ,KAQ,Kalitta Air LLC,2,0,0,0,0,0,0,3221168,4524751,7745919,0,0,0,0,0,0,6897031,10854673,17751704,2019
4,21629,KD,KD,Western Global,2,0,0,0,0,0,0,1569264,892204,2461468,0,0,0,0,0,0,3415879,1930528,5346407,2019
4,21634,KH,KH,Aloha Air Cargo,2,392414,0,0,0,0,392414,392414,0,392414,793241,0,0,0,0,793241,793241,0,793241,2019
4,20372,KLQ,KLQ,Kalitta Charters II,1,0,0,0,0,0,0,198608,29459,228067,0,0,0,0,0,0,501851,77618,579469,2019
4,20169,L2,L2,Lynden Air Cargo Airlines,1,97484,0,0,0,0,97484,151911,15563,167474,248212,0,0,0,0,248212,375287,47958,423245,2019
4,20151,M6,M6,Amerijet International,2,0,0,0,1533857,1533857,1533857,554946,1716275,2271221,0,0,0,3465591,3465591,3465591,1253843,3877746,5131589,2019
4,20398,MQ,MQ,Envoy Air,3,0,0,0,0,0,0,0,0,0,0,0,0,0,0,0,0,0,0,2019
4,20405,N8,N8,National Air Cargo Group Inc d/ba National Airlines,2,0,0,0,0,0,0,74323,1357215,1431538,0,0,0,0,0,0,236905,3849238,4086143,2019
4,20108,NC,NC,Northern Air Cargo Inc.,1,271829,0,0,0,0,271829,322129,0,322129,603087,0,0,0,0,603087,697107,0,697107,2019
4,20416,NK,NK,Spirit Air Lines,3,33760047,0,0,4911255,4911255,38671302,33760047,4911255,38671302,74222807,0,0,10797590,10797590,85020397,74222807,10797590,85020397,2019
4,20397,OH,OH,PSA Airlines Inc.,2,0,0,0,0,0,0,0,0,0,0,0,0,0,0,0,0,0,0,2019
4,20304,OO,OO,SkyWest Airlines Inc.,3,8262780,0,0,0,0,8262780,8262780,0,8262780,20297087,0,0,0,0,20297087,20297087,0,20297087,2019
4,20177,PFQ,PFQ,Asia Pacific,1,0,0,0,0,0,0,0,389461,389461,0,0,0,0,0,0,0,900577,900577,2019
4,20100,PO,PO,Polar Air Cargo Airways,3,2399267,701876,10945472,0,11647348,14046615,2399267,11647348,14046615,4948050,1541758,21476395,0,23018153,27966203,4948050,23018153,27966203,2019
4,19687,QX,QX,Horizon Air,2,0,0,0,0,0,0,0,0,0,0,0,0,0,0,0,0,0,0,2019
4,20422,SY,SY,Sun Country Airlines d/b/a MN Airlines,2,4069973,0,0,987765,987765,5057738,4758911,1034854,5793765,8956181,0,0,2352138,2352138,11308319,11676816,2464930,14141746,2019
4,20447,U7,U7,USA Jet Airlines Inc.,2,0,0,0,0,0,0,276938,17958,294896,0,0,0,0,0,0,567626,62363,629989,2019
4,19977,UA,UA,United Air Lines Inc.,3,144590058,60523632,51831017,31206029,143560678,288150736,145411013,143673409,289084422,294430837,122350380,106637727,66383872,295371979,589802816,296103451,295602761,591706212,2019
4,20195,WI,WI,Sky Lease Cargo,2,0,0,0,0,0,0,0,1803776,1803776,0,0,0,0,0,0,0,4015883,4015883,2019
4,20310,WL,WL,"Caribbean Sun Airlines, Inc. d/b/a World Atlantic Airlines",1,0,0,0,0,0,0,78060,1268,79328,0,0,0,0,0,0,220182,3577,223759,2019
4,20377,X9,X9,Omni Air International LLC,2,0,0,0,0,0,0,395064,3622989,4018053,0,0,0,0,0,0,1065262,8945485,10010747,2019
4,20207,XP,XP,XTRA Airways,1,0,0,0,0,0,0,0,0,0,0,0,0,0,0,0,0,0,0,2019
4,20378,YV,YV,Mesa Airlines Inc.,2,0,0,0,0,0,0,0,0,0,0,0,0,0,0,0,0,0,0,2019
4,20452,YX,YX,Republic Airline,3,13919,0,0,0,0,13919,13919,0,13919,29889,0,0,0,0,29889,29889,0,29889,2019
4,19393,WN,WN,Southwest Airlines Co.,3,171401778,0,0,1931660,1931660,173333438,171492052,1931660,173423712,343356856,0,0,4787040,4787040,348143896,343556447,4787040,348343487,2019
5,21161,09Q,09Q,"Swift Air, LLC d/b/a Eastern Air Lines d/b/a Eastern",2,0,0,0,0,0,0,675825,757128,1432953,0,0,0,0,0,0,1744273,1120059,2864332,2019
5,21352,0WQ,0WQ,Avjet Corporation,1,0,0,0,0,0,0,0,0,0,0,0,0,0,0,0,0,0,0,2019
5,21492,1BQ,1BQ,"Eastern Airlines f/k/a Dynamic Airways, LLC",1,0,0,0,0,0,0,0,21082,21082,0,0,0,0,0,0,0,79229,79229,2019
5,21652,27Q,27Q,"Jet Aviation Flight Services, Inc.",1,0,0,0,0,0,0,0,0,0,0,0,0,0,0,0,0,0,0,2019
5,21712,2HQ,2HQ,Elite Airways LLC,1,165353,0,0,0,0,165353,273216,0,273216,619426,0,0,0,0,619426,941715,0,941715,2019
5,21974,3EQ,3EQ,"Scott Aviation, LLC  d/b/a  Silver Air",1,0,0,0,0,0,0,0,0,0,0,0,0,0,0,0,0,0,0,2019
5,20408,5V,5V,Tatonduk Outfitters Limited d/b/a Everts Air Alaska and Everts Air Cargo,1,326698,0,0,0,0,326698,366102,0,366102,924717,0,0,0,0,924717,1036250,0,1036250,2019
5,19917,5X,5X,United Parcel Service,3,42867000,12352000,17383000,3093000,32828000,75695000,42867000,32828000,75695000,90692000,25298000,36826000,6761000,68885000,159577000,90692000,68885000,159577000,2019
5,20007,5Y,5Y,Atlas Air Inc.,3,0,0,0,0,0,0,16247567,33279659,49527226,0,0,0,0,0,0,37213237,75650997,112864234,2019
5,19874,8C,8C,Air Transport International,2,0,0,0,0,0,0,59164,787542,846706,0,0,0,0,0,0,170069,2049934,2220003,2019
5,20363,9E,9E,Endeavor Air Inc.,2,0,0,0,0,0,0,0,0,0,0,0,0,0,0,0,0,0,0,2019
5,20190,9S,9S,Southern Air Inc.,2,1263017,2393561,4254975,0,6648536,7911553,1263017,6648536,7911553,2865185,5947372,9593079,0,15540451,18405636,2865185,15540451,18405636,2019
5,19805,AA,AA,American Airlines Inc.,3,195424647,61637649,19301832,43014750,123954231,319378878,195785035,124187098,319972133,400384570,126601880,40130901,92299450,259032231,659416801,401108088,259545007,660653095,2019
5,20453,ABX,ABX,ABX Air Inc,2,149718,0,0,0,0,149718,149718,0,149718,0,0,0,0,0,0,0,0,0,2019
5,19930,AS,AS,Alaska Airlines Inc.,3,61891326,0,0,846925,846925,62738251,61930261,846925,62777186,149060140,0,0,2331235,2331235,151391375,149141897,2331235,151473132,2019
5,20409,B6,B6,JetBlue Airways,3,59139308,0,0,15399970,15399970,74539278,59139308,15399970,74539278,132733065,0,0,34563901,34563901,167296966,132733065,34563901,167296966,2019
5,21167,CP,CP,Compass Airlines,2,0,0,0,0,0,0,0,0,0,0,0,0,0,0,0,0,0,0,2019
5,19790,DL,DL,Delta Air Lines Inc.,3,186758571,74949599,31995527,22808196,129753322,316511893,188366304,129806984,318173288,383651451,153966280,65727267,46854062,266547609,650199060,388155077,266657846,654812923,2019
5,20366,EV,EV,ExpressJet Airlines LLC,2,0,0,0,0,0,0,0,0,0,0,0,0,0,0,0,0,0,0,2019
5,20436,F9,F9,Frontier Airlines Inc.,3,22805754,0,0,1785895,1785895,24591649,22805754,1785895,24591649,42822137,0,0,3867858,3867858,46689995,42822137,3867858,46689995,2019
5,20107,FX,FX,Federal Express Corporation,3,60239135,16083295,23077883,2115040,41276218,101515353,62012233,42102155,104114388,125755000,32967000,48274000,4982000,86223000,211978000,129525000,88226000,217751000,2019
5,20368,G4,G4,Allegiant Air,3,15895717,0,0,0,0,15895717,16288199,206601,16494800,36874836,0,0,0,0,36874836,37843745,493218,38336963,2019
5,20500,G7,G7,GoJet Airlines LLC d/b/a United Express,2,0,0,0,0,0,0,0,0,0,0,0,0,0,0,0,0,0,0,2019
5,20166,GFQ,GFQ,Gulf And Caribbean Cargo,1,0,0,0,0,0,0,101151,110668,211819,0,0,0,0,0,0,264738,308875,573613,2019
5,20402,GL,GL,Miami Air International,2,0,0,0,0,0,0,153537,249455,402992,0,0,0,0,0,0,453072,736117,1189189,2019
5,19690,HA,HA,Hawaiian Airlines Inc.,3,16143998,0,6761601,0,6761601,22905599,16143998,6761601,22905599,34161814,0,13846292,0,13846292,48008106,34161814,13846292,48008106,2019
5,20370,KAQ,KAQ,Kalitta Air LLC,2,0,0,0,0,0,0,2757277,3733101,6490378,0,0,0,0,0,0,5976523,8986877,14963400,2019
5,21629,KD,KD,Western Global,2,0,0,0,0,0,0,1025832,1073257,2099089,0,0,0,0,0,0,2330691,2428578,4759269,2019
5,21634,KH,KH,Aloha Air Cargo,2,387931,0,0,0,0,387931,387931,0,387931,796746,0,0,0,0,796746,796746,0,796746,2019
5,20372,KLQ,KLQ,Kalitta Charters II,1,0,0,0,0,0,0,112766,43894,156660,0,0,0,0,0,0,298448,126383,424831,2019
5,20169,L2,L2,Lynden Air Cargo Airlines,1,131178,0,0,0,0,131178,285985,72421,358406,356252,0,0,0,0,356252,789250,86941,876191,2019
5,20151,M6,M6,Amerijet International,2,0,0,0,1736422,1736422,1736422,512239,1796706,2308945,0,0,0,3953951,3953951,3953951,1166403,4091222,5257625,2019
5,20398,MQ,MQ,Envoy Air,3,0,0,0,0,0,0,0,0,0,0,0,0,0,0,0,0,0,0,2019
5,20405,N8,N8,National Air Cargo Group Inc d/ba National Airlines,2,0,0,0,0,0,0,31001,1134112,1165113,0,0,0,0,0,0,114406,3347119,3461525,2019
5,20108,NC,NC,Northern Air Cargo Inc.,1,182675,0,0,0,0,182675,210015,0,210015,436829,0,0,0,0,436829,502062,0,502062,2019
5,20416,NK,NK,Spirit Air Lines,3,37152807,0,0,4970557,4970557,42123364,37152807,4970557,42123364,83576243,0,0,11181402,11181402,94757645,83576243,11181402,94757645,2019
5,20397,OH,OH,PSA Airlines Inc.,2,0,0,0,0,0,0,0,0,0,0,0,0,0,0,0,0,0,0,2019
5,20304,OO,OO,SkyWest Airlines Inc.,3,8838081,0,0,0,0,8838081,8838081,0,8838081,22436510,0,0,0,0,22436510,22436510,0,22436510,2019
5,20177,PFQ,PFQ,Asia Pacific,1,0,0,0,0,0,0,0,363290,363290,0,0,0,0,0,0,0,834670,834670,2019
5,20100,PO,PO,Polar Air Cargo Airways,3,2756574,722700,11759138,0,12481838,15238412,2756574,12481838,15238412,5758153,1613922,24108440,0,25722362,31480515,5758153,25722362,31480515,2019
5,19687,QX,QX,Horizon Air,2,0,0,0,0,0,0,0,0,0,0,0,0,0,0,0,0,0,0,2019
5,20422,SY,SY,Sun Country Airlines d/b/a MN Airlines,2,4023182,0,0,304836,304836,4328018,5044703,403404,5448107,9089834,0,0,755802,755802,9845636,11488221,996564,12484785,2019
5,20447,U7,U7,USA Jet Airlines Inc.,2,0,0,0,0,0,0,317305,9687,326992,0,0,0,0,0,0,686029,32703,718732,2019
5,19977,UA,UA,United Air Lines Inc.,3,153202004,73294536,54098845,27860083,155253464,308455468,153949739,155465624,309415363,322624581,152795530,115391388,60866483,329053401,651677982,324208102,329510626,653718728,2019
5,20195,WI,WI,Sky Lease Cargo,2,0,0,0,0,0,0,11147,1212285,1223432,0,0,0,0,0,0,26946,2730784,2757730,2019
5,20310,WL,WL,"Caribbean Sun Airlines, Inc. d/b/a World Atlantic Airlines",1,0,0,0,0,0,0,46985,247955,294940,0,0,0,0,0,0,89588,472786,562374,2019
5,20377,X9,X9,Omni Air International LLC,2,0,0,0,0,0,0,613723,2690826,3304549,0,0,0,0,0,0,1477851,6740872,8218723,2019
5,20207,XP,XP,XTRA Airways,1,0,0,0,0,0,0,0,0,0,0,0,0,0,0,0,0,0,0,2019
5,20378,YV,YV,Mesa Airlines Inc.,2,0,0,0,0,0,0,0,0,0,0,0,0,0,0,0,0,0,0,2019
5,20452,YX,YX,Republic Airline,3,18888,0,0,0,0,18888,18888,0,18888,41578,0,0,0,0,41578,41578,0,41578,2019
5,19393,WN,WN,Southwest Airlines Co.,3,177347813,0,0,2473278,2473278,179821091,177441553,2473278,179914831,371652892,0,0,6309955,6309955,377962847,371853619,6309955,378163574,2019
6,21161,09Q,09Q,"Swift Air, LLC d/b/a Eastern Air Lines d/b/a Eastern",2,0,0,0,0,0,0,401512,808223,1209735,0,0,0,0,0,0,877762,1742073,2619835,2019
6,21352,0WQ,0WQ,Avjet Corporation,1,0,0,0,0,0,0,0,0,0,0,0,0,0,0,0,0,0,0,2019
6,21492,1BQ,1BQ,"Eastern Airlines f/k/a Dynamic Airways, LLC",1,0,0,0,0,0,0,3864,70432,74296,0,0,0,0,0,0,18431,252722,271153,2019
6,21652,27Q,27Q,"Jet Aviation Flight Services, Inc.",1,0,0,0,0,0,0,0,0,0,0,0,0,0,0,0,0,0,0,2019
6,21712,2HQ,2HQ,Elite Airways LLC,1,110195,0,0,0,0,110195,168234,0,168234,311439,0,0,0,0,311439,493559,0,493559,2019
6,21974,3EQ,3EQ,"Scott Aviation, LLC  d/b/a  Silver Air",1,0,0,0,0,0,0,0,0,0,0,0,0,0,0,0,0,0,0,2019
6,20408,5V,5V,Tatonduk Outfitters Limited d/b/a Everts Air Alaska and Everts Air Cargo,1,301172,0,0,0,0,301172,355723,0,355723,782334,0,0,0,0,782334,924038,0,924038,2019
6,19917,5X,5X,United Parcel Service,3,40665000,12187000,16966000,2717000,31870000,72535000,40665000,31870000,72535000,77414000,23959000,34428000,5613000,64000000,141414000,77414000,64000000,141414000,2019
6,20007,5Y,5Y,Atlas Air Inc.,3,0,0,0,0,0,0,15732351,31496344,47228695,0,0,0,0,0,0,35076392,69904163,104980555,2019
6,19874,8C,8C,Air Transport International,2,0,0,0,0,0,0,43052,730813,773865,0,0,0,0,0,0,120829,1883667,2004496,2019
6,20363,9E,9E,Endeavor Air Inc.,2,0,0,0,0,0,0,0,0,0,0,0,0,0,0,0,0,0,0,2019
6,20190,9S,9S,Southern Air Inc.,2,1094965,2102642,3714691,2186,5819519,6914484,1094965,5819519,6914484,2409767,5182766,7919857,4005,13106628,15516395,2409767,13106628,15516395,2019
6,19805,AA,AA,American Airlines Inc.,3,195670252,67039590,19020928,45291083,131351601,327021853,195915483,131521720,327437203,373907739,130140181,37402156,94460076,262002413,635910152,374377915,262365817,636743732,2019
6,20453,ABX,ABX,ABX Air Inc,2,133419,0,0,0,0,133419,133419,0,133419,0,0,0,0,0,0,0,0,0,2019
6,19930,AS,AS,Alaska Airlines Inc.,3,63813286,0,0,678278,678278,64491564,63899921,678278,64578199,135821357,0,0,1666785,1666785,137488142,135989040,1666785,137655825,2019
6,20409,B6,B6,JetBlue Airways,3,57899767,0,0,16881416,16881416,74781183,57899767,16881416,74781183,119555227,0,0,34857852,34857852,154413079,119555227,34857852,154413079,2019
6,21167,CP,CP,Compass Airlines,2,0,0,0,0,0,0,0,0,0,0,0,0,0,0,0,0,0,0,2019
6,19790,DL,DL,Delta Air Lines Inc.,3,196666953,83530097,31788396,22790222,138108715,334775668,198074942,138108715,336183657,416406190,176859655,67306095,48254113,292419863,708826053,420444587,292419863,712864450,2019
6,20366,EV,EV,ExpressJet Airlines LLC,2,0,0,0,0,0,0,0,0,0,0,0,0,0,0,0,0,0,0,2019
6,20436,F9,F9,Frontier Airlines Inc.,3,22899112,0,0,1697218,1697218,24596330,22899112,1697218,24596330,41286065,0,0,3355771,3355771,44641836,41286065,3355771,44641836,2019
6,20107,FX,FX,Federal Express Corporation,3,55563857,14693105,22286076,1903348,38882529,94446386,56983007,39523503,96506510,103990000,28220000,45180000,4332000,77732000,181722000,106681494,79155000,185836494,2019
6,20368,G4,G4,Allegiant Air,3,19637023,0,0,0,0,19637023,19947115,232353,20179468,41412959,0,0,0,0,41412959,42106026,527704,42633730,2019
6,20500,G7,G7,GoJet Airlines LLC d/b/a United Express,2,0,0,0,0,0,0,0,0,0,0,0,0,0,0,0,0,0,0,2019
6,20166,GFQ,GFQ,Gulf And Caribbean Cargo,1,0,0,0,0,0,0,177454,75579,253033,0,0,0,0,0,0,447931,201992,649923,2019
6,20402,GL,GL,Miami Air International,2,0,0,0,0,0,0,149225,319809,469034,0,0,0,0,0,0,404431,866750,1271181,2019
6,19690,HA,HA,Hawaiian Airlines Inc.,3,15667787,0,6670038,0,6670038,22337825,15667787,6670038,22337825,29621947,0,12917461,0,12917461,42539408,29621947,12917461,42539408,2019
6,20370,KAQ,KAQ,Kalitta Air LLC,2,0,0,0,0,0,0,3052250,4644761,7697011,0,0,0,0,0,0,5945440,10508398,16453838,2019
6,21629,KD,KD,Western Global,2,0,0,0,0,0,0,1842149,1078869,2921018,0,0,0,0,0,0,3835839,2328684,6164523,2019
6,21634,KH,KH,Aloha Air Cargo,2,396366,0,0,0,0,396366,396366,0,396366,743516,0,0,0,0,743516,743516,0,743516,2019
6,20372,KLQ,KLQ,Kalitta Charters II,1,0,0,0,0,0,0,138345,9808,148153,0,0,0,0,0,0,380505,22377,402882,2019
6,20169,L2,L2,Lynden Air Cargo Airlines,1,185144,0,0,0,0,185144,336245,61566,397811,443441,0,0,0,0,443441,844329,196299,1040628,2019
6,20151,M6,M6,Amerijet International,2,0,0,0,1585401,1585401,1585401,500791,1690049,2190840,0,0,0,3426975,3426975,3426975,1082501,3653180,4735681,2019
6,20398,MQ,MQ,Envoy Air,3,0,0,0,0,0,0,0,0,0,0,0,0,0,0,0,0,0,0,2019
6,20405,N8,N8,National Air Cargo Group Inc d/ba National Airlines,2,0,0,0,0,0,0,110460,437315,547775,0,0,0,0,0,0,374003,1555405,1929408,2019
6,20108,NC,NC,Northern Air Cargo Inc.,1,259324,0,0,0,0,259324,407071,0,407071,507435,0,0,0,0,507435,787763,0,787763,2019
6,20416,NK,NK,Spirit Air Lines,3,36737363,0,0,4914976,4914976,41652339,36737363,4914976,41652339,75170578,0,0,10056835,10056835,85227413,75170578,10056835,85227413,2019
6,20397,OH,OH,PSA Airlines Inc.,2,0,0,0,0,0,0,0,0,0,0,0,0,0,0,0,0,0,0,2019
6,20304,OO,OO,SkyWest Airlines Inc.,3,8915291,0,0,0,0,8915291,8915291,0,8915291,20779214,0,0,0,0,20779214,20779214,0,20779214,2019
6,20177,PFQ,PFQ,Asia Pacific,1,0,0,0,0,0,0,0,333834,333834,0,0,0,0,0,0,0,765867,765867,2019
6,20100,PO,PO,Polar Air Cargo Airways,3,2980851,709842,11761339,0,12471181,15452032,2980851,12471181,15452032,5662856,1567724,23591976,0,25159700,30822556,5662856,25159700,30822556,2019
6,19687,QX,QX,Horizon Air,2,0,0,0,0,0,0,0,0,0,0,0,0,0,0,0,0,0,0,2019
6,20422,SY,SY,Sun Country Airlines d/b/a MN Airlines,2,5374879,0,0,911178,911178,6286057,6200681,968745,7169426,11081522,0,0,2135113,2135113,13216635,13077984,2267662,15345646,2019
6,20447,U7,U7,USA Jet Airlines Inc.,2,0,0,0,0,0,0,448144,14417,462561,0,0,0,0,0,0,899896,44743,944639,2019
6,19977,UA,UA,United Air Lines Inc.,3,158802116,75616971,53292139,31692487,160601597,319403713,159500662,160737489,320238151,306347461,147753982,106826039,65593766,320173787,626521248,307713727,320455909,628169636,2019
6,20195,WI,WI,Sky Lease Cargo,2,0,0,0,0,0,0,0,566138,566138,0,0,0,0,0,0,0,1189220,1189220,2019
6,20310,WL,WL,"Caribbean Sun Airlines, Inc. d/b/a World Atlantic Airlines",1,0,0,0,0,0,0,159403,134150,293553,0,0,0,0,0,0,253766,213564,467330,2019
6,20377,X9,X9,Omni Air International LLC,2,0,0,0,0,0,0,426101,3070130,3496231,0,0,0,0,0,0,934804,7368962,8303766,2019
6,20207,XP,XP,XTRA Airways,1,0,0,0,0,0,0,0,0,0,0,0,0,0,0,0,0,0,0,2019
6,20378,YV,YV,Mesa Airlines Inc.,2,0,0,0,0,0,0,0,0,0,0,0,0,0,0,0,0,0,0,2019
6,20452,YX,YX,Republic Airline,3,18137,0,0,0,0,18137,18137,0,18137,38021,0,0,0,0,38021,38021,0,38021,2019
6,19393,WN,WN,Southwest Airlines Co.,3,176316720,0,0,2713632,2713632,179030352,176417715,2713632,179131347,351393094,0,0,6375770,6375770,357768864,351593930,6375770,357969700,2019
7,21161,09Q,09Q,"Swift Air, LLC d/b/a Eastern Air Lines d/b/a Eastern",2,0,0,0,0,0,0,312166,2103361,2415527,0,0,0,0,0,0,1043401,1812328,2855729,2019
7,21352,0WQ,0WQ,Avjet Corporation,1,0,0,0,0,0,0,0,0,0,0,0,0,0,0,0,0,0,0,2019
7,21492,1BQ,1BQ,"Eastern Airlines f/k/a Dynamic Airways, LLC",1,0,0,0,0,0,0,4053,62740,66793,0,0,0,0,0,0,15848,169033,184881,2019
7,21652,27Q,27Q,"Jet Aviation Flight Services, Inc.",1,0,0,0,0,0,0,0,0,0,0,0,0,0,0,0,0,0,0,2019
7,21712,2HQ,2HQ,Elite Airways LLC,1,109064,0,0,0,0,109064,157065,0,157065,308439,0,0,0,0,308439,500082,0,500082,2019
7,21974,3EQ,3EQ,"Scott Aviation, LLC  d/b/a  Silver Air",1,0,0,0,0,0,0,0,0,0,0,0,0,0,0,0,0,0,0,2019
7,20408,5V,5V,Tatonduk Outfitters Limited d/b/a Everts Air Alaska and Everts Air Cargo,1,390874,0,0,0,0,390874,426753,0,426753,1015464,0,0,0,0,1015464,1114248,0,1114248,2019
7,19917,5X,5X,United Parcel Service,3,45011000,12242000,18078000,2880000,33200000,78211000,45011000,33200000,78211000,88737000,23379000,34914000,6038000,64331000,153068000,88737000,64331000,153068000,2019
7,20007,5Y,5Y,Atlas Air Inc.,3,0,0,0,0,0,0,16123997,34078678,50202675,0,0,0,0,0,0,36371051,76224609,112595660,2019
7,19874,8C,8C,Air Transport International,2,0,0,0,0,0,0,47205,812855,860060,0,0,0,0,0,0,129601,2172139,2301740,2019
7,20363,9E,9E,Endeavor Air Inc.,2,0,0,0,0,0,0,0,0,0,0,0,0,0,0,0,0,0,0,2019
7,20190,9S,9S,Southern Air Inc.,2,1227334,2293129,4301038,0,6594167,7821501,1227334,6594167,7821501,2734807,5379671,9087076,0,14466747,17201554,2734807,14466747,17201554,2019
7,19805,AA,AA,American Airlines Inc.,3,200601221,70341415,20023724,47225419,137590558,338191779,200831199,137763844,338595043,385858147,136632087,38137388,97101514,271870989,657729136,386300528,272226731,658527259,2019
7,20453,ABX,ABX,ABX Air Inc,2,158928,0,0,0,0,158928,158928,0,158928,0,0,0,0,0,0,0,0,0,2019
7,19930,AS,AS,Alaska Airlines Inc.,3,66937916,0,0,623643,623643,67561559,66996749,623643,67620392,145117185,0,0,1576430,1576430,146693615,145232985,1576430,146809415,2019
7,20409,B6,B6,JetBlue Airways,3,60919004,0,0,18857771,18857771,79776775,60919004,18857771,79776775,127696495,0,0,39529064,39529064,167225559,127696495,39529064,167225559,2019
7,21167,CP,CP,Compass Airlines,2,0,0,0,0,0,0,0,0,0,0,0,0,0,0,0,0,0,0,2019
7,19790,DL,DL,Delta Air Lines Inc.,3,206257947,87307829,33130839,23280029,143718697,349976644,207363151,143769991,351133142,403679204,170875137,64842256,45562675,281280068,684959272,407109894,281380458,688490352,2019
7,20366,EV,EV,ExpressJet Airlines LLC,2,0,0,0,0,0,0,0,0,0,0,0,0,0,0,0,0,0,0,2019
7,20436,F9,F9,Frontier Airlines Inc.,3,25073216,0,0,1603336,1603336,26676552,25073216,1603336,26676552,47012069,0,0,3387238,3387238,50399307,47012069,3387238,50399307,2019
7,20107,FX,FX,Federal Express Corporation,3,54376496,15381075,23096897,2089891,40567863,94944359,56012289,41427349,97439638,106677000,30169000,44699000,4719000,79587000,186264000,109927000,81629159,191556159,2019
7,20368,G4,G4,Allegiant Air,3,21131147,0,0,0,0,21131147,21534807,164400,21699207,46518327,0,0,0,0,46518327,47444838,378124,47822962,2019
7,20500,G7,G7,GoJet Airlines LLC d/b/a United Express,2,0,0,0,0,0,0,0,0,0,0,0,0,0,0,0,0,0,0,2019
7,20166,GFQ,GFQ,Gulf And Caribbean Cargo,1,0,0,0,0,0,0,111751,89010,200761,0,0,0,0,0,0,302753,250802,553555,2019
7,20402,GL,GL,Miami Air International,2,0,0,0,0,0,0,156364,302210,458574,0,0,0,0,0,0,421359,814374,1235733,2019
7,19690,HA,HA,Hawaiian Airlines Inc.,3,16087016,0,7194376,0,7194376,23281392,16087016,7194376,23281392,31347956,0,13709257,0,13709257,45057213,31347956,13709257,45057213,2019
7,20370,KAQ,KAQ,Kalitta Air LLC,2,0,0,0,0,0,0,2702001,3739270,6441271,0,0,0,0,0,0,5485728,8393881,13879609,2019
7,21629,KD,KD,Western Global,2,0,0,0,0,0,0,1400576,1108388,2508964,0,0,0,0,0,0,3202909,2611665,5814574,2019
7,21634,KH,KH,Aloha Air Cargo,2,429557,0,0,0,0,429557,429557,0,429557,822598,0,0,0,0,822598,822598,0,822598,2019
7,20372,KLQ,KLQ,Kalitta Charters II,1,0,0,0,0,0,0,105957,20731,126688,0,0,0,0,0,0,270552,56333,326885,2019
7,20169,L2,L2,Lynden Air Cargo Airlines,1,251838,0,0,0,0,251838,403722,9300,413022,578466,0,0,0,0,578466,1012104,21123,1033227,2019
7,20151,M6,M6,Amerijet International,2,0,0,0,1389919,1389919,1389919,861701,1507262,2368963,0,0,0,3113867,3113867,3113867,1930489,3376753,5307242,2019
7,20398,MQ,MQ,Envoy Air,3,0,0,0,0,0,0,0,0,0,0,0,0,0,0,0,0,0,0,2019
7,20405,N8,N8,National Air Cargo Group Inc d/ba National Airlines,2,0,0,0,0,0,0,75831,819230,895061,0,0,0,0,0,0,241209,2904645,3145854,2019
7,20108,NC,NC,Northern Air Cargo Inc.,1,314989,0,0,0,0,314989,421503,0,421503,663094,0,0,0,0,663094,890009,0,890009,2019
7,20416,NK,NK,Spirit Air Lines,3,38320573,0,0,5028491,5028491,43349064,38320573,5028491,43349064,80953479,0,0,10622855,10622855,91576334,80953479,10622855,91576334,2019
7,20397,OH,OH,PSA Airlines Inc.,2,0,0,0,0,0,0,0,0,0,0,0,0,0,0,0,0,0,0,2019
7,20304,OO,OO,SkyWest Airlines Inc.,3,9566241,0,0,0,0,9566241,9566241,0,9566241,21469274,0,0,0,0,21469274,21469274,0,21469274,2019
7,20177,PFQ,PFQ,Asia Pacific,1,0,0,0,0,0,0,0,421335,421335,0,0,0,0,0,0,0,885651,885651,2019
7,20100,PO,PO,Polar Air Cargo Airways,3,2583178,604648,11253822,0,11858470,14441648,2583178,11858470,14441648,5168602,1268450,21168491,0,22436941,27605543,5168602,22436941,27605543,2019
7,19687,QX,QX,Horizon Air,2,0,0,0,0,0,0,0,0,0,0,0,0,0,0,0,0,0,0,2019
7,20422,SY,SY,Sun Country Airlines d/b/a MN Airlines,2,3762872,0,0,887445,887445,4650317,4198458,1001072,5199530,8123838,0,0,2083838,2083838,10207676,9214238,2343883,11558121,2019
7,20447,U7,U7,USA Jet Airlines Inc.,2,0,0,0,0,0,0,287984,18532,306516,0,0,0,0,0,0,597567,53308,650875,2019
7,19977,UA,UA,United Air Lines Inc.,3,163602359,76391495,54888033,33224952,164504480,328106839,164295066,164694081,328989147,318916771,149560487,106573191,68329653,324463331,643380102,320251056,324816300,645067356,2019
7,20195,WI,WI,Sky Lease Cargo,2,0,0,0,0,0,0,0,727737,727737,0,0,0,0,0,0,0,1594189,1594189,2019
7,20310,WL,WL,"Caribbean Sun Airlines, Inc. d/b/a World Atlantic Airlines",1,0,0,0,0,0,0,41492,91090,132582,0,0,0,0,0,0,120015,263476,383491,2019
7,20377,X9,X9,Omni Air International LLC,2,0,0,0,0,0,0,357883,3779166,4137049,0,0,0,0,0,0,747727,8858287,9606014,2019
7,20207,XP,XP,XTRA Airways,1,0,0,0,0,0,0,0,0,0,0,0,0,0,0,0,0,0,0,2019
7,20378,YV,YV,Mesa Airlines Inc.,2,0,0,0,0,0,0,0,0,0,0,0,0,0,0,0,0,0,0,2019
7,20452,YX,YX,Republic Airline,3,27361,0,0,0,0,27361,27361,0,27361,56688,0,0,0,0,56688,56688,0,56688,2019
7,19393,WN,WN,Southwest Airlines Co.,3,182539375,0,0,2459214,2459214,184998589,182640130,2459214,185099344,362437125,0,0,5797137,5797137,368234262,362654100,5797137,368451237,2019
8,21161,09Q,09Q,"Swift Air, LLC d/b/a Eastern Air Lines d/b/a Eastern",2,0,0,0,0,0,0,288920,691498,980418,0,0,0,0,0,0,1041710,1818583,2860293,2019
8,21352,0WQ,0WQ,Avjet Corporation,1,0,0,0,0,0,0,0,0,0,0,0,0,0,0,0,0,0,0,2019
8,21492,1BQ,1BQ,"Eastern Airlines f/k/a Dynamic Airways, LLC",1,0,0,0,0,0,0,7072,23540,30612,0,0,0,0,0,0,27652,61083,88735,2019
8,21652,27Q,27Q,"Jet Aviation Flight Services, Inc.",1,0,0,0,0,0,0,0,0,0,0,0,0,0,0,0,0,0,0,2019
8,21712,2HQ,2HQ,Elite Airways LLC,1,114588,0,0,0,0,114588,145383,0,145383,317125,0,0,0,0,317125,414672,0,414672,2019
8,21974,3EQ,3EQ,"Scott Aviation, LLC  d/b/a  Silver Air",1,0,0,0,0,0,0,0,0,0,0,0,0,0,0,0,0,0,0,2019
8,20408,5V,5V,Tatonduk Outfitters Limited d/b/a Everts Air Alaska and Everts Air Cargo,1,370652,0,0,0,0,370652,459018,0,459018,873615,0,0,0,0,873615,1084816,0,1084816,2019
8,19917,5X,5X,United Parcel Service,3,43409000,11670000,17516000,2780000,31966000,75375000,43409000,31966000,75375000,82869000,22553000,34673000,5678000,62904000,145773000,82869000,62904000,145773000,2019
8,20007,5Y,5Y,Atlas Air Inc.,3,0,0,0,0,0,0,16764718,33741803,50506521,0,0,0,0,0,0,36170901,75762297,111933198,2019
8,19874,8C,8C,Air Transport International,2,0,0,0,0,0,0,23473,778506,801979,0,0,0,0,0,0,48341,2041138,2089479,2019
8,20363,9E,9E,Endeavor Air Inc.,2,0,0,0,0,0,0,0,0,0,0,0,0,0,0,0,0,0,0,2019
8,20190,9S,9S,Southern Air Inc.,2,1251684,2364388,4516590,1848,6882826,8134510,1251684,6882826,8134510,2657455,5556135,9699503,4077,15259715,17917170,2657455,15259715,17917170,2019
8,19805,AA,AA,American Airlines Inc.,3,202894574,70336377,20270807,44174310,134781494,337676068,203192653,135003848,338196501,381039943,134812431,38814044,90720075,264346550,645386493,381593620,264788688,646382308,2019
8,20453,ABX,ABX,ABX Air Inc,2,159484,0,0,0,0,159484,159484,0,159484,0,0,0,0,0,0,0,0,0,2019
8,19930,AS,AS,Alaska Airlines Inc.,3,66006281,0,0,511217,511217,66517498,66100174,511217,66611391,137929922,0,0,1242006,1242006,139171928,138106879,1242006,139348885,2019
8,20409,B6,B6,JetBlue Airways,3,60585417,0,0,19173518,19173518,79758935,60585417,19173518,79758935,124292370,0,0,39334911,39334911,163627281,124292370,39334911,163627281,2019
8,21167,CP,CP,Compass Airlines,2,0,0,0,0,0,0,0,0,0,0,0,0,0,0,0,0,0,0,2019
8,19790,DL,DL,Delta Air Lines Inc.,3,205778169,87613874,33320826,23272261,144206961,349985130,206920890,144206961,351127851,391476743,166678488,63390244,44273642,274342374,665819117,394893012,274342374,669235386,2019
8,20366,EV,EV,ExpressJet Airlines LLC,2,0,0,0,0,0,0,0,0,0,0,0,0,0,0,0,0,0,0,2019
8,20436,F9,F9,Frontier Airlines Inc.,3,25512256,0,0,520291,520291,26032547,25512256,520291,26032547,46146191,0,0,1223415,1223415,47369606,46146191,1223415,47369606,2019
8,20107,FX,FX,Federal Express Corporation,3,57600477,15042547,23085768,2110647,40238962,97839439,59321547,41058655,100380202,108349000,28487000,44810000,4671000,77968000,186317000,111635000,79758327,191393327,2019
8,20368,G4,G4,Allegiant Air,3,15347680,0,0,0,0,15347680,16090859,119327,16210186,32802872,0,0,0,0,32802872,34499210,265855,34765065,2019
8,20500,G7,G7,GoJet Airlines LLC d/b/a United Express,2,0,0,0,0,0,0,0,0,0,0,0,0,0,0,0,0,0,0,2019
8,20166,GFQ,GFQ,Gulf And Caribbean Cargo,1,0,0,0,0,0,0,94612,158323,252935,0,0,0,0,0,0,236707,414614,651321,2019
8,20402,GL,GL,Miami Air International,2,0,0,0,0,0,0,145261,210220,355481,0,0,0,0,0,0,396679,574068,970747,2019
8,19690,HA,HA,Hawaiian Airlines Inc.,3,16136273,0,7592735,0,7592735,23729008,16190448,7592735,23783183,30475345,0,14487191,0,14487191,44962536,30576646,14487191,45063837,2019
8,20370,KAQ,KAQ,Kalitta Air LLC,2,0,0,0,0,0,0,3180454,4656457,7836911,0,0,0,0,0,0,8799806,9331809,18131615,2019
8,21629,KD,KD,Western Global,2,0,0,0,0,0,0,802348,531102,1333450,0,0,0,0,0,0,1748652,1278423,3027075,2019
8,21634,KH,KH,Aloha Air Cargo,2,423687,0,0,0,0,423687,423687,0,423687,799725,0,0,0,0,799725,799725,0,799725,2019
8,20372,KLQ,KLQ,Kalitta Charters II,1,0,0,0,0,0,0,57736,56575,114311,0,0,0,0,0,0,156971,149454,306425,2019
8,20169,L2,L2,Lynden Air Cargo Airlines,1,175233,0,0,0,0,175233,290578,18933,309511,388236,0,0,0,0,388236,668960,51135,720095,2019
8,20151,M6,M6,Amerijet International,2,0,0,0,1143201,1143201,1143201,1170963,1158873,2329836,0,0,0,2460322,2460322,2460322,2520070,2494050,5014120,2019
8,20398,MQ,MQ,Envoy Air,3,0,0,0,0,0,0,0,0,0,0,0,0,0,0,0,0,0,0,2019
8,20405,N8,N8,National Air Cargo Group Inc d/ba National Airlines,2,0,0,0,0,0,0,26529,84542,111071,0,0,0,0,0,0,95400,1441243,1536643,2019
8,20108,NC,NC,Northern Air Cargo Inc.,1,320321,0,0,0,0,320321,465418,0,465418,637138,0,0,0,0,637138,913881,0,913881,2019
8,20416,NK,NK,Spirit Air Lines,3,39098822,0,0,3725737,3725737,42824559,39098822,3725737,42824559,81114551,0,0,7729426,7729426,88843977,81114551,7729426,88843977,2019
8,20397,OH,OH,PSA Airlines Inc.,2,0,0,0,0,0,0,0,0,0,0,0,0,0,0,0,0,0,0,2019
8,20304,OO,OO,SkyWest Airlines Inc.,3,8790766,0,0,0,0,8790766,8790766,0,8790766,21267349,0,0,0,0,21267349,21267349,0,21267349,2019
8,20177,PFQ,PFQ,Asia Pacific,1,0,0,0,0,0,0,0,386916,386916,0,0,0,0,0,0,0,860924,860924,2019
8,20100,PO,PO,Polar Air Cargo Airways,3,2215213,277803,9758768,0,10036571,12251784,2215213,10036571,12251784,4305348,596347,19332871,0,19929218,24234566,4305348,19929218,24234566,2019
8,19687,QX,QX,Horizon Air,2,0,0,0,0,0,0,0,0,0,0,0,0,0,0,0,0,0,0,2019
8,20422,SY,SY,Sun Country Airlines d/b/a MN Airlines,2,5660560,0,0,465642,465642,6126202,6572865,508671,7081536,11754627,0,0,1077215,1077215,12831842,13305447,1125983,14431430,2019
8,20447,U7,U7,USA Jet Airlines Inc.,2,0,0,0,0,0,0,462203,38169,500372,0,0,0,0,0,0,924554,106556,1031110,2019
8,19977,UA,UA,United Air Lines Inc.,3,162360183,75508731,55800390,29621923,160931044,323291227,163531864,161156564,324688428,308413848,145753696,109459063,60135055,315347814,623761662,310650235,315782939,626433174,2019
8,20195,WI,WI,Sky Lease Cargo,2,0,0,0,0,0,0,0,908243,908243,0,0,0,0,0,0,0,1956967,1956967,2019
8,20310,WL,WL,"Caribbean Sun Airlines, Inc. d/b/a World Atlantic Airlines",1,0,0,0,0,0,0,50866,56582,107448,0,0,0,0,0,0,192018,213596,405614,2019
8,20377,X9,X9,Omni Air International LLC,2,0,0,0,0,0,0,446849,2916847,3363696,0,0,0,0,0,0,985794,7364118,8349912,2019
8,20207,XP,XP,XTRA Airways,1,0,0,0,0,0,0,0,0,0,0,0,0,0,0,0,0,0,0,2019
8,20378,YV,YV,Mesa Airlines Inc.,2,0,0,0,0,0,0,0,0,0,0,0,0,0,0,0,0,0,0,2019
8,20452,YX,YX,Republic Airline,3,22245,0,0,0,0,22245,22245,0,22245,46383,0,0,0,0,46383,46383,0,46383,2019
8,19393,WN,WN,Southwest Airlines Co.,3,175218927,0,0,1702372,1702372,176921299,175268660,1702372,176971032,342805103,0,0,3911530,3911530,346716633,342904670,3911530,346816200,2019
9,21161,09Q,09Q,"Swift Air, LLC d/b/a Eastern Air Lines d/b/a Eastern",2,0,0,0,0,0,0,415270,592868,1008138,0,0,0,0,0,0,1430024,1166525,2596549,2019
9,21352,0WQ,0WQ,Avjet Corporation,1,0,0,0,0,0,0,0,0,0,0,0,0,0,0,0,0,0,0,2019
9,21492,1BQ,1BQ,"Eastern Airlines f/k/a Dynamic Airways, LLC",1,0,0,0,0,0,0,76144,171305,247449,0,0,0,0,0,0,241376,543037,784413,2019
9,21652,27Q,27Q,"Jet Aviation Flight Services, Inc.",1,0,0,0,0,0,0,0,0,0,0,0,0,0,0,0,0,0,0,2019
9,21712,2HQ,2HQ,Elite Airways LLC,1,59983,0,0,0,0,59983,148395,0,148395,170051,0,0,0,0,170051,508180,0,508180,2019
9,21974,3EQ,3EQ,"Scott Aviation, LLC  d/b/a  Silver Air",1,0,0,0,0,0,0,0,0,0,0,0,0,0,0,0,0,0,0,2019
9,20408,5V,5V,Tatonduk Outfitters Limited d/b/a Everts Air Alaska and Everts Air Cargo,1,265824,0,0,0,0,265824,361624,0,361624,685649,0,0,0,0,685649,932749,0,932749,2019
9,19917,5X,5X,United Parcel Service,3,40870000,11611000,17578000,2688000,31877000,72747000,40870000,31877000,72747000,78729000,21978000,33721000,5508000,61207000,139936000,78729000,61207000,139936000,2019
9,20007,5Y,5Y,Atlas Air Inc.,3,0,0,0,0,0,0,16151077,32502107,48653184,0,0,0,0,0,0,35106509,70017869,105124378,2019
9,19874,8C,8C,Air Transport International,2,0,0,0,0,0,0,26608,792993,819601,0,0,0,0,0,0,88364,2058257,2146621,2019
9,20363,9E,9E,Endeavor Air Inc.,2,0,0,0,0,0,0,0,0,0,0,0,0,0,0,0,0,0,0,2019
9,20190,9S,9S,Southern Air Inc.,2,1483224,1806170,4563581,2382,6372133,7855357,1483224,6372133,7855357,3168937,4260364,9141496,4944,13406804,16575741,3168937,13406804,16575741,2019
9,19805,AA,AA,American Airlines Inc.,3,181813413,67638705,19477349,34306860,121422914,303236327,182204854,121649993,303854847,345924380,129770834,36726420,68621603,235118857,581043237,346653565,235586871,582240436,2019
9,20453,ABX,ABX,ABX Air Inc,2,135237,0,0,0,0,135237,135237,0,135237,0,0,0,0,0,0,0,0,0,2019
9,19930,AS,AS,Alaska Airlines Inc.,3,58265437,0,0,412339,412339,58677776,58438446,412339,58850785,124638578,0,0,1012403,1012403,125650981,124973656,1012403,125986059,2019
9,20409,B6,B6,JetBlue Airways,3,55213771,0,0,13820935,13820935,69034706,55217487,13820935,69038422,112127451,0,0,28067386,28067386,140194837,112135306,28067386,140202692,2019
9,21167,CP,CP,Compass Airlines,2,0,0,0,0,0,0,0,0,0,0,0,0,0,0,0,0,0,0,2019
9,19790,DL,DL,Delta Air Lines Inc.,3,174872651,77709987,30630186,19138771,127478944,302351595,176327569,127564141,303891710,346038440,153772717,60611089,37871849,252255655,598294095,349929240,252424244,602353484,2019
9,20366,EV,EV,ExpressJet Airlines LLC,2,0,0,0,0,0,0,0,0,0,0,0,0,0,0,0,0,0,0,2019
9,20436,F9,F9,Frontier Airlines Inc.,3,23951656,0,0,237248,237248,24188904,23951656,237248,24188904,44956844,0,0,500174,500174,45457018,44956844,500174,45457018,2019
9,20107,FX,FX,Federal Express Corporation,3,50173214,15833052,22022838,1944140,39800030,89973244,51632985,40856222,92489207,95907000,30802000,42649000,4108000,77559000,173466000,98738055,79999000,178737055,2019
9,20368,G4,G4,Allegiant Air,3,9559460,0,0,0,0,9559460,10437749,96221,10533970,20468604,0,0,0,0,20468604,22545157,216912,22762069,2019
9,20500,G7,G7,GoJet Airlines LLC d/b/a United Express,2,0,0,0,0,0,0,0,0,0,0,0,0,0,0,0,0,0,0,2019
9,20166,GFQ,GFQ,Gulf And Caribbean Cargo,1,0,0,0,0,0,0,255268,117077,372345,0,0,0,0,0,0,617906,311012,928918,2019
9,20402,GL,GL,Miami Air International,2,0,0,0,0,0,0,311216,193027,504243,0,0,0,0,0,0,841790,522107,1363897,2019
9,19690,HA,HA,Hawaiian Airlines Inc.,3,15017176,0,7545606,0,7545606,22562782,15139018,7545606,22684624,28680909,0,14159401,0,14159401,42840310,28914379,14159401,43073780,2019
9,20370,KAQ,KAQ,Kalitta Air LLC,2,0,0,0,0,0,0,2675407,3756806,6432213,0,0,0,0,0,0,5306614,8277885,13584499,2019
9,21629,KD,KD,Western Global,2,0,0,0,0,0,0,1358616,1201536,2560152,0,0,0,0,0,0,2943828,2318117,5261945,2019
9,21634,KH,KH,Aloha Air Cargo,2,390699,0,0,0,0,390699,390699,0,390699,743115,0,0,0,0,743115,743115,0,743115,2019
9,20372,KLQ,KLQ,Kalitta Charters II,1,0,0,0,0,0,0,141016,9701,150717,0,0,0,0,0,0,368715,23471,392186,2019
9,20169,L2,L2,Lynden Air Cargo Airlines,1,117491,0,0,0,0,117491,273184,60684,333868,257300,0,0,0,0,257300,614202,171374,785576,2019
9,20151,M6,M6,Amerijet International,2,0,0,0,1036569,1036569,1036569,971269,1102972,2074241,0,0,0,2247051,2247051,2247051,2105494,2390998,4496492,2019
9,20398,MQ,MQ,Envoy Air,3,0,0,0,0,0,0,0,0,0,0,0,0,0,0,0,0,0,0,2019
9,20405,N8,N8,National Air Cargo Group Inc d/ba National Airlines,2,0,0,0,0,0,0,14485,377779,392264,0,0,0,0,0,0,80523,2001703,2082226,2019
9,20108,NC,NC,Northern Air Cargo Inc.,1,279169,0,0,0,0,279169,368557,0,368557,570190,0,0,0,0,570190,747636,0,747636,2019
9,20416,NK,NK,Spirit Air Lines,3,32308811,0,0,3589868,3589868,35898679,32308811,3589868,35898679,66084009,0,0,7342668,7342668,73426677,66084009,7342668,73426677,2019
9,20397,OH,OH,PSA Airlines Inc.,2,0,0,0,0,0,0,0,0,0,0,0,0,0,0,0,0,0,0,2019
9,20304,OO,OO,SkyWest Airlines Inc.,3,8834786,0,0,0,0,8834786,8834786,0,8834786,20313626,0,0,0,0,20313626,20313626,0,20313626,2019
9,20177,PFQ,PFQ,Asia Pacific,1,0,0,0,0,0,0,0,351884,351884,0,0,0,0,0,0,0,743639,743639,2019
9,20100,PO,PO,Polar Air Cargo Airways,3,2183045,655524,9078100,0,9733624,11916669,2183045,9733624,11916669,4216942,1368117,16932957,0,18301074,22518016,4216942,18301074,22518016,2019
9,19687,QX,QX,Horizon Air,2,0,0,0,0,0,0,0,0,0,0,0,0,0,0,0,0,0,0,2019
9,20422,SY,SY,Sun Country Airlines d/b/a MN Airlines,2,3723905,0,0,33703,33703,3757608,5029452,78537,5107989,7838208,0,0,66983,66983,7905191,10675385,157036,10832421,2019
9,20447,U7,U7,USA Jet Airlines Inc.,2,0,0,0,0,0,0,457621,46047,503668,0,0,0,0,0,0,917567,128227,1045794,2019
9,19977,UA,UA,United Air Lines Inc.,3,141650742,76362770,51251749,21997143,149611662,291262404,142963521,149948902,292912423,269880307,146157283,98447438,43893813,288498534,558378841,272383646,289135932,561519578,2019
9,20195,WI,WI,Sky Lease Cargo,2,0,0,0,0,0,0,0,1083142,1083142,0,0,0,0,0,0,0,2302795,2302795,2019
9,20310,WL,WL,"Caribbean Sun Airlines, Inc. d/b/a World Atlantic Airlines",1,0,0,0,0,0,0,29403,24865,54268,0,0,0,0,0,0,19975,16892,36867,2019
9,20377,X9,X9,Omni Air International LLC,2,0,0,0,0,0,0,369977,3573437,3943414,0,0,0,0,0,0,808310,8797931,9606241,2019
9,20207,XP,XP,XTRA Airways,1,0,0,0,0,0,0,0,0,0,0,0,0,0,0,0,0,0,0,2019
9,20378,YV,YV,Mesa Airlines Inc.,2,0,0,0,0,0,0,0,0,0,0,0,0,0,0,0,0,0,0,2019
9,20452,YX,YX,Republic Airline,3,22895,0,0,0,0,22895,22895,0,22895,46818,0,0,0,0,46818,46818,0,46818,2019
9,19393,WN,WN,Southwest Airlines Co.,3,161363187,0,0,1035797,1035797,162398984,161469375,1035797,162505172,317050854,0,0,2343476,2343476,319394330,317265738,2343476,319609214,2019
1,21161,09Q,09Q,"Swift Air, LLC d/b/a Eastern Air Lines d/b/a Eastern",1,0,0,0,0,0,0,484770,982656,1467426,0,0,0,0,0,0,1504939,2703344,4208283,2018
1,21352,0WQ,0WQ,Avjet Corporation,1,0,0,0,0,0,0,38515,1210,39725,0,0,0,0,0,0,141350,4721,146071,2018
1,21652,27Q,27Q,"Jet Aviation Flight Services, Inc.",1,0,0,0,0,0,0,0,0,0,0,0,0,0,0,0,0,0,0,2018
1,21712,2HQ,2HQ,Elite Airways LLC,1,89988,0,0,0,0,89988,,0,462132,252948,0,0,0,0,252948,1785834,0,1785834,2018
1,20408,5V,5V,Tatonduk Outfitters Limited d/b/a Everts Air Alaska and Everts Air Cargo,1,309045,0,0,0,0,309045,364447,0,364447,837738,0,0,0,0,837738,987918,0,987918,2018
1,19917,5X,5X,United Parcel Service,3,39478000,11475000,17906000,3091000,32472000,71950000,39478000,32472000,71950000,79343000,22593000,34871000,6568000,64032000,143375000,79343000,64032000,143375000,2018
1,20007,5Y,5Y,Atlas Air Inc.,3,0,0,0,0,0,0,11947570,31103365,43050935,0,0,0,0,0,0,23833293,61556400,85389693,2018
1,19874,8C,8C,Air Transport International,2,0,0,0,0,0,0,74865,722440,797305,0,0,0,0,0,0,173708,1516586,1690294,2018
1,20363,9E,9E,Endeavor Air Inc.,2,0,0,0,0,0,0,0,0,0,0,0,0,0,0,0,0,0,0,2018
1,20190,9S,9S,Southern Air Inc.,2,676247,4092478,570460,0,4662938,5339185,676247,4662938,5339185,1420119,8594204,1197966,0,9792170,11212289,1420119,9792170,11212289,2018
1,19805,AA,AA,American Airlines Inc.,3,173505482,35052146,24241613,50238019,109531778,283037260,174171571,109802500,283974071,337146683,69965049,47361096,104353301,221679446,558826129,338396257,222238669,560634926,2018
1,20453,ABX,ABX,ABX Air Inc,2,44160,0,0,0,0,44160,44160,0,44160,100111,0,0,0,0,100111,100111,0,100111,2018
1,19930,AS,AS,Alaska Airlines Inc.,3,56426937,0,0,1540038,1540038,57966975,56468118,1540038,58008156,121074317,0,0,3506973,3506973,124581290,121153924,3506973,124660897,2018
1,20409,B6,B6,JetBlue Airways,3,53977431,0,0,12900982,12900982,66878413,53985306,12900982,66886288,114612170,0,0,27393107,27393107,142005277,114629092,27393107,142022199,2018
1,21167,CP,CP,Compass Airlines,2,0,0,0,0,0,0,0,0,0,0,0,0,0,0,0,0,0,0,2018
1,19790,DL,DL,Delta Air Lines Inc.,3,155927269,46437915,29704100,30677967,106819982,262747251,157691468,106874624,264566092,321399594,95718517,61226531,63233879,220178927,541578521,326289455,220291555,546581010,2018
1,20366,EV,EV,ExpressJet Airlines Inc.,3,0,0,0,0,0,0,0,0,0,0,0,0,0,0,0,0,0,0,2018
1,20436,F9,F9,Frontier Airlines Inc.,3,19838849,0,0,2367542,2367542,22206391,19838849,2367542,22206391,38873888,0,0,4706056,4706056,43579944,38873888,4706056,43579944,2018
1,20107,FX,FX,Federal Express Corporation,3,56827364,13372611,21530230,1992053,36894894,93722258,58608033,37324100,95932133,113558000,27068000,42280000,4326000,73674000,187232000,117140326,74527000,191667326,2018
1,20368,G4,G4,Allegiant Air,3,13661026,0,0,0,0,13661026,14124731,59298,14184029,30199307,0,0,0,0,30199307,31266501,150033,31416534,2018
1,20500,G7,G7,GoJet Airlines LLC d/b/a United Express,2,0,0,0,0,0,0,0,0,0,0,0,0,0,0,0,0,0,0,2018
1,20166,GFQ,GFQ,Gulf And Caribbean Cargo,1,0,0,0,0,0,0,191279,266093,457372,0,0,0,0,0,0,462989,690943,1153932,2018
1,20402,GL,GL,Miami Air International,2,0,0,0,0,0,0,363126,234130,597256,0,0,0,0,0,0,1139536,734730,1874266,2018
1,19690,HA,HA,Hawaiian Airlines Inc.,3,15104660,0,7316195,0,7316195,22420855,15115998,7316195,22432193,29872091,0,14224772,0,14224772,44096863,29894018,14224772,44118790,2018
1,20370,KAQ,KAQ,Kalitta Air LLC,2,0,0,0,0,0,0,698701,3118500,3817201,0,0,0,0,0,0,1434317,6834833,8269150,2018
1,21629,KD,KD,Western Global,1,0,0,0,0,0,0,586944,497165,1084109,0,0,0,0,0,0,965656,1091841,2057497,2018
1,21634,KH,KH,Aloha Air Cargo,1,432202,0,0,0,0,432202,432202,0,432202,863451,0,0,0,0,863451,863451,0,863451,2018
1,20372,KLQ,KLQ,Kalitta Charters II,1,0,0,0,0,0,0,89058,79804,168862,0,0,0,0,0,0,238881,217715,456596,2018
1,20169,L2,L2,Lynden Air Cargo Airlines,1,92605,0,0,0,0,92605,168707,43964,212671,221954,0,0,0,0,221954,432443,139490,571933,2018
1,20151,M6,M6,Amerijet International,2,0,0,0,1393584,1393584,1393584,382418,1450106,1832524,0,0,0,3054888,3054888,3054888,838302,3178790,4017092,2018
1,20398,MQ,MQ,Envoy Air,3,0,0,0,0,0,0,0,0,0,0,0,0,0,0,0,0,0,0,2018
1,20405,N8,N8,National Air Cargo Group Inc d/ba National Airlines,1,0,0,0,0,0,0,48091,1065432,1113523,0,0,0,0,0,0,122419,2202006,2324425,2018
1,20108,NC,NC,Northern Air Cargo Inc.,1,359210,0,0,0,0,359210,473048,4327,477375,808844,0,0,0,0,808844,1052458,9770,1062228,2018
1,20416,NK,NK,Spirit Air Lines,3,29081619,0,0,2528836,2528836,31610455,29081619,2528836,31610455,63997667,0,0,5565015,5565015,69562682,63997667,5565015,69562682,2018
1,20397,OH,OH,PSA Airlines Inc.,2,0,0,0,0,0,0,0,0,0,0,0,0,0,0,0,0,0,0,2018
1,20304,OO,OO,SkyWest Airlines Inc.,3,7718601,0,0,0,0,7718601,7718601,0,7718601,18509402,0,0,0,0,18509402,18509402,0,18509402,2018
1,20177,PFQ,PFQ,Asia Pacific,1,0,0,0,0,0,0,0,383900,383900,0,0,0,0,0,0,0,834814,834814,2018
1,20100,PO,PO,Polar Air Cargo Airways,3,2702434,808761,11467813,0,12276574,14979008,2702434,12276574,14979008,5474104,1962033,21260028,0,23222061,28696165,5474104,23222061,28696165,2018
1,19687,QX,QX,Horizon Air,2,0,0,0,0,0,0,0,0,0,0,0,0,0,0,0,0,0,0,2018
1,20422,SY,SY,Sun Country Airlines d/b/a MN Airlines,2,3173913,0,0,1374684,1374684,4548597,3605952,1537296,5143248,6516582,0,0,3175518,3175518,9692100,8392084,3553659,11945743,2018
1,20447,U7,U7,USA Jet Airlines Inc.,2,0,0,0,0,0,0,327303,15135,342438,0,0,0,0,0,0,667469,43725,711194,2018
1,19977,UA,UA,United Air Lines Inc.,3,120128303,49380913,54011106,31260979,134652998,254781301,120886857,135095219,255982076,237636702,97620436,105935311,64407817,267963564,505600266,239129660,268814169,507943829,2018
1,20195,WI,WI,Sky Lease Cargo,1,0,0,0,0,0,0,0,2131746,2131746,0,0,0,0,0,0,0,4668490,4668490,2018
1,20310,WL,WL,"Caribbean Sun Airlines, Inc. d/b/a World Atlantic Airlines",1,0,0,0,0,0,0,21791,60597,82388,0,0,0,0,0,0,55729,154973,210702,2018
1,20377,X9,X9,Omni Air International LLC,2,0,0,0,0,0,0,375924,2691363,3067287,0,0,0,0,0,0,802044,5545449,6347493,2018
1,20207,XP,XP,XTRA Airways,1,0,0,0,0,0,0,304290,246038,550328,0,0,0,0,0,0,687478,807982,1495460,2018
1,20378,YV,YV,Mesa Airlines Inc.,2,0,0,0,0,0,0,0,0,0,0,0,0,0,0,0,0,0,0,2018
1,20452,YX,YX,Republic Airline,2,22451,0,0,0,0,22451,22451,0,22451,52500,0,0,0,0,52500,52500,0,52500,2018
1,19393,WN,WN,Southwest Airlines Co.,3,161138026,0,0,1834713,1834713,162972739,161332466,1834713,163167179,315017449,0,0,4296170,4296170,319313619,315397696,4296170,319693866,2018
2,21161,09Q,09Q,"Swift Air, LLC d/b/a Eastern Air Lines d/b/a Eastern",1,0,0,0,0,0,0,399309,1248916,1648225,0,0,0,0,0,0,1254933,3192284,4447217,2018
2,21352,0WQ,0WQ,Avjet Corporation,1,0,0,0,0,0,0,22645,1881,24526,0,0,0,0,0,0,78351,7692,86043,2018
2,21652,27Q,27Q,"Jet Aviation Flight Services, Inc.",1,0,0,0,0,0,0,0,0,0,0,0,0,0,0,0,0,0,0,2018
2,21712,2HQ,2HQ,Elite Airways LLC,1,101235,0,0,0,0,101235,,0,436099,280448,0,0,0,0,280448,1657337,0,1657337,2018
2,20408,5V,5V,Tatonduk Outfitters Limited d/b/a Everts Air Alaska and Everts Air Cargo,1,258734,0,0,0,0,258734,329727,0,329727,668021,0,0,0,0,668021,851317,0,851317,2018
2,19917,5X,5X,United Parcel Service,3,35568000,9735000,13013000,2981000,25729000,61297000,35568000,25729000,61297000,70212000,19633000,26570000,6209000,52412000,122624000,70212000,52412000,122624000,2018
2,20007,5Y,5Y,Atlas Air Inc.,3,0,0,0,0,0,0,10087978,26285976,36373954,0,0,0,0,0,0,20195085,54229365,74424450,2018
2,19874,8C,8C,Air Transport International,2,0,0,0,0,0,0,48487,672843,721330,0,0,0,0,0,0,118249,1413961,1532210,2018
2,20363,9E,9E,Endeavor Air Inc.,2,0,0,0,0,0,0,0,0,0,0,0,0,0,0,0,0,0,0,2018
2,20190,9S,9S,Southern Air Inc.,2,521988,3452285,738867,0,4191152,4713140,521988,4191152,4713140,1096175,7249799,1551621,0,8801420,9897595,1096175,8801420,9897595,2018
2,19805,AA,AA,American Airlines Inc.,3,163176583,31153826,21936945,44993754,98084525,261261108,163705922,98240465,261946387,320337213,62220618,43790860,94212692,200224170,520561383,321390510,200591763,521982273,2018
2,20453,ABX,ABX,ABX Air Inc,2,52160,0,0,0,0,52160,52160,0,52160,109537,0,0,0,0,109537,109537,0,109537,2018
2,19930,AS,AS,Alaska Airlines Inc.,3,51807689,0,0,1345887,1345887,53153576,51844705,1345887,53190592,110059390,0,0,3095810,3095810,113155200,110131726,3095810,113227536,2018
2,20409,B6,B6,JetBlue Airways,3,51025522,0,0,11723595,11723595,62749117,51031327,11723595,62754922,107825043,0,0,24773821,24773821,132598864,107836097,24773821,132609918,2018
2,21167,CP,CP,Compass Airlines,2,0,0,0,0,0,0,0,0,0,0,0,0,0,0,0,0,0,0,2018
2,19790,DL,DL,Delta Air Lines Inc.,3,148189448,40541056,25331999,27498466,93371521,241560969,149957685,93583853,243541538,303310994,82978567,51848995,56283272,191110834,494421828,308111950,191545431,499657381,2018
2,20366,EV,EV,ExpressJet Airlines Inc.,3,0,0,0,0,0,0,0,0,0,0,0,0,0,0,0,0,0,0,2018
2,20436,F9,F9,Frontier Airlines Inc.,3,18114909,0,0,2047245,2047245,20162154,18116710,2047245,20163955,35140062,0,0,4216569,4216569,39356631,35144267,4216569,39360836,2018
2,20107,FX,FX,Federal Express Corporation,3,56243514,12818924,18672981,1969459,33461364,89704878,57620127,33883163,91503290,110215000,25828000,37870000,4351000,68049000,178264000,112936000,68893000,181829000,2018
2,20368,G4,G4,Allegiant Air,3,14427198,0,0,0,0,14427198,14924168,73468,14997636,31350279,0,0,0,0,31350279,32447801,172055,32619856,2018
2,20500,G7,G7,GoJet Airlines LLC d/b/a United Express,2,0,0,0,0,0,0,0,0,0,0,0,0,0,0,0,0,0,0,2018
2,20166,GFQ,GFQ,Gulf And Caribbean Cargo,1,0,0,0,0,0,0,314756,190021,504777,0,0,0,0,0,0,770075,487714,1257789,2018
2,20402,GL,GL,Miami Air International,2,0,0,0,0,0,0,370382,307870,678252,0,0,0,0,0,0,963282,800701,1763983,2018
2,19690,HA,HA,Hawaiian Airlines Inc.,3,13451832,0,6576087,0,6576087,20027919,13460835,6576087,20036922,26651890,0,13113313,0,13113313,39765203,26669581,13113313,39782894,2018
2,20370,KAQ,KAQ,Kalitta Air LLC,2,0,0,0,0,0,0,729082,3326011,4055093,0,0,0,0,0,0,1465169,7438269,8903438,2018
2,21629,KD,KD,Western Global,1,0,0,0,0,0,0,303157,1627321,1930478,0,0,0,0,0,0,678656,866112,1544768,2018
2,21634,KH,KH,Aloha Air Cargo,1,397609,0,0,0,0,397609,397609,0,397609,797072,0,0,0,0,797072,797072,0,797072,2018
2,20372,KLQ,KLQ,Kalitta Charters II,1,0,0,0,0,0,0,138216,66973,205189,0,0,0,0,0,0,358574,181434,540008,2018
2,20169,L2,L2,Lynden Air Cargo Airlines,1,92806,0,0,0,0,92806,131649,72991,204640,211767,0,0,0,0,211767,295503,240202,535705,2018
2,20151,M6,M6,Amerijet International,2,0,0,0,1316818,1316818,1316818,376567,1404937,1781504,0,0,0,2845347,2845347,2845347,813677,3035752,3849429,2018
2,20398,MQ,MQ,Envoy Air,3,0,0,0,0,0,0,0,0,0,0,0,0,0,0,0,0,0,0,2018
2,20405,N8,N8,National Air Cargo Group Inc d/ba National Airlines,1,0,0,0,0,0,0,40867,816673,857540,0,0,0,0,0,0,129227,1879383,2008610,2018
2,20108,NC,NC,Northern Air Cargo Inc.,1,296605,0,0,0,0,296605,434555,1460,436015,669470,0,0,0,0,669470,969018,3383,972401,2018
2,20416,NK,NK,Spirit Air Lines,3,27408648,0,0,2351013,2351013,29759661,27408648,2351013,29759661,59719696,0,0,5122536,5122536,64842232,59719696,5122536,64842232,2018
2,20397,OH,OH,PSA Airlines Inc.,2,0,0,0,0,0,0,0,0,0,0,0,0,0,0,0,0,0,0,2018
2,20304,OO,OO,SkyWest Airlines Inc.,3,7207367,0,0,0,0,7207367,7207367,0,7207367,16860769,0,0,0,0,16860769,16860769,0,16860769,2018
2,20177,PFQ,PFQ,Asia Pacific,1,0,0,0,0,0,0,0,303623,303623,0,0,0,0,0,0,0,703710,703710,2018
2,20100,PO,PO,Polar Air Cargo Airways,3,2179797,629657,9604275,0,10233932,12413729,2179797,10233932,12413729,4433842,1507491,18725077,0,20232568,24666410,4433842,20232568,24666410,2018
2,19687,QX,QX,Horizon Air,2,0,0,0,0,0,0,0,0,0,0,0,0,0,0,0,0,0,0,2018
2,20422,SY,SY,Sun Country Airlines d/b/a MN Airlines,2,3108023,0,0,2102534,2102534,5210557,3471449,2370204,5841653,6604870,0,0,4734992,4734992,11339862,8366308,5343460,13709768,2018
2,20447,U7,U7,USA Jet Airlines Inc.,2,0,0,0,0,0,0,411195,16439,427634,0,0,0,0,0,0,819664,51479,871143,2018
2,19977,UA,UA,United Air Lines Inc.,3,112265317,45864734,49097012,27092594,122054340,234319657,113046868,122415882,235462750,223503554,92113254,100380803,57016884,249510941,473014495,225059256,250253729,475312985,2018
2,20195,WI,WI,Sky Lease Cargo,1,0,0,0,0,0,0,0,1690406,1690406,0,0,0,0,0,0,0,3783985,3783985,2018
2,20310,WL,WL,"Caribbean Sun Airlines, Inc. d/b/a World Atlantic Airlines",1,0,0,0,0,0,0,28716,32448,61164,0,0,0,0,0,0,119183,134673,253856,2018
2,20377,X9,X9,Omni Air International LLC,2,0,0,0,0,0,0,318940,3116692,3435632,0,0,0,0,0,0,715629,6146452,6862081,2018
2,20207,XP,XP,XTRA Airways,1,0,0,0,0,0,0,330777,118790,449567,0,0,0,0,0,0,714686,497306,1211992,2018
2,20378,YV,YV,Mesa Airlines Inc.,2,0,0,0,0,0,0,0,0,0,0,0,0,0,0,0,0,0,0,2018
2,20452,YX,YX,Republic Airline,2,22181,0,0,0,0,22181,22181,0,22181,53380,0,0,0,0,53380,53380,0,53380,2018
2,19393,WN,WN,Southwest Airlines Co.,3,145012888,0,0,1842002,1842002,146854890,145201747,1842002,147043749,291089205,0,0,4363233,4363233,295452438,291461320,4363233,295824553,2018
3,21161,09Q,09Q,"Swift Air, LLC d/b/a Eastern Air Lines d/b/a Eastern",1,0,0,0,0,0,0,841501,1697854,2539355,0,0,0,0,0,0,3111986,3082180,6194166,2018
3,21352,0WQ,0WQ,Avjet Corporation,1,0,0,0,0,0,0,25849,1467,27316,0,0,0,0,0,0,89438,5854,95292,2018
3,21492,1BQ,1BQ,"Eastern Airlines f/k/a Dynamic Airways, LLC",1,0,0,0,0,0,0,4608,205142,209750,0,0,0,0,0,0,11182,497848,509030,2018
3,21652,27Q,27Q,"Jet Aviation Flight Services, Inc.",1,0,0,0,0,0,0,0,0,0,0,0,0,0,0,0,0,0,0,2018
3,21712,2HQ,2HQ,Elite Airways LLC,1,117588,0,0,0,0,117588,314298,0,314298,326234,0,0,0,0,326234,1090313,0,1090313,2018
3,20408,5V,5V,Tatonduk Outfitters Limited d/b/a Everts Air Alaska and Everts Air Cargo,1,301822,0,0,0,0,301822,384615,0,384615,848517,0,0,0,0,848517,1081274,0,1081274,2018
3,19917,5X,5X,United Parcel Service,3,38682000,11954000,16881000,2978000,31813000,70495000,38682000,31813000,70495000,74536000,23702000,34070000,6132000,63904000,138440000,74536000,63904000,138440000,2018
3,20007,5Y,5Y,Atlas Air Inc.,3,0,0,0,0,0,0,10950720,30291875,41242595,0,0,0,0,0,0,21676080,62563518,84239598,2018
3,19874,8C,8C,Air Transport International,2,0,0,0,0,0,0,40462,737845,778307,0,0,0,0,0,0,104655,1591858,1696513,2018
3,20363,9E,9E,Endeavor Air Inc.,2,0,0,0,0,0,0,0,0,0,0,0,0,0,0,0,0,0,0,2018
3,20190,9S,9S,Southern Air Inc.,2,611065,2124696,3250299,4536,5379531,5990596,611065,5379531,5990596,1203298,4722572,6498052,9292,11229916,12433214,1203298,11229916,12433214,2018
3,19805,AA,AA,American Airlines Inc.,3,182348195,40295922,24251327,50939305,115486554,297834749,183156469,115749775,298906244,350495737,79156948,47816591,104139931,231113470,581609207,352054533,231705618,583760151,2018
3,20453,ABX,ABX,ABX Air Inc,2,61992,0,0,0,0,61992,61992,0,61992,125224,0,0,0,0,125224,125224,0,125224,2018
3,19930,AS,AS,Alaska Airlines Inc.,3,59506677,0,0,1541993,1541993,61048670,59544847,1541993,61086840,125875596,0,0,3480382,3480382,129355978,125950923,3480382,129431305,2018
3,20409,B6,B6,JetBlue Airways,3,56332511,0,0,13250153,13250153,69582664,56342861,13250153,69593014,115122701,0,0,27078384,27078384,142201085,115143298,27078384,142221682,2018
3,21167,CP,CP,Compass Airlines,2,0,0,0,0,0,0,0,0,0,0,0,0,0,0,0,0,0,0,2018
3,19790,DL,DL,Delta Air Lines Inc.,3,179103474,49612332,29766902,31089280,110468514,289571988,181163772,110714430,291878202,339503165,94043646,56425245,58931905,209400796,548903961,344828575,209866945,554695520,2018
3,20366,EV,EV,ExpressJet Airlines Inc.,3,0,0,0,0,0,0,0,0,0,0,0,0,0,0,0,0,0,0,2018
3,20436,F9,F9,Frontier Airlines Inc.,3,19200534,0,0,2237233,2237233,21437767,19201138,2237233,21438371,36021672,0,0,4465459,4465459,40487131,36023042,4465459,40488501,2018
3,20107,FX,FX,Federal Express Corporation,3,62074222,14426617,21947761,2150940,38525318,100599540,63697908,39064228,102762136,118691000,28638000,43830000,4513000,76981000,195672000,121843616,78182000,200025616,2018
3,20368,G4,G4,Allegiant Air,3,18783338,0,0,0,0,18783338,19325569,132764,19458333,39939768,0,0,0,0,39939768,41147005,302943,41449948,2018
3,20500,G7,G7,GoJet Airlines LLC d/b/a United Express,2,0,0,0,0,0,0,0,0,0,0,0,0,0,0,0,0,0,0,2018
3,20166,GFQ,GFQ,Gulf And Caribbean Cargo,1,0,0,0,0,0,0,193705,154439,348144,0,0,0,0,0,0,450979,394299,845278,2018
3,20402,GL,GL,Miami Air International,2,0,0,0,0,0,0,464935,546363,1011298,0,0,0,0,0,0,1163779,1367601,2531380,2018
3,19690,HA,HA,Hawaiian Airlines Inc.,3,15390145,0,7419967,0,7419967,22810112,15390145,7419967,22810112,30024860,0,14645936,0,14645936,44670796,30024860,14645936,44670796,2018
3,20370,KAQ,KAQ,Kalitta Air LLC,2,0,0,0,0,0,0,1017046,3615063,4632109,0,0,0,0,0,0,1967553,7873273,9840826,2018
3,21629,KD,KD,Western Global,1,0,0,0,0,0,0,409946,566284,976230,0,0,0,0,0,0,890349,1348481,2238830,2018
3,21634,KH,KH,Aloha Air Cargo,1,426607,0,0,0,0,426607,426607,0,426607,842919,0,0,0,0,842919,842919,0,842919,2018
3,20372,KLQ,KLQ,Kalitta Charters II,1,0,0,0,0,0,0,162599,75158,237757,0,0,0,0,0,0,421266,190604,611870,2018
3,20169,L2,L2,Lynden Air Cargo Airlines,1,128312,0,0,0,0,128312,171099,12840,183939,291460,0,0,0,0,291460,380955,28208,409163,2018
3,20151,M6,M6,Amerijet International,2,0,0,0,1490389,1490389,1490389,490507,1716685,2207192,0,0,0,3244421,3244421,3244421,1067782,3737044,4804826,2018
3,20398,MQ,MQ,Envoy Air,3,0,0,0,0,0,0,0,0,0,0,0,0,0,0,0,0,0,0,2018
3,20405,N8,N8,National Air Cargo Group Inc d/ba National Airlines,1,0,0,0,0,0,0,87207,1368849,1456056,0,0,0,0,0,0,280103,3240158,3520261,2018
3,20108,NC,NC,Northern Air Cargo Inc.,1,357315,0,0,0,0,357315,537041,22228,559269,770871,0,0,0,0,770871,1133609,39772,1173381,2018
3,20416,NK,NK,Spirit Air Lines,3,30875049,0,0,2757902,2757902,33632951,30875049,2757902,33632951,64480985,0,0,5759739,5759739,70240724,64480985,5759739,70240724,2018
3,20397,OH,OH,PSA Airlines Inc.,2,0,0,0,0,0,0,0,0,0,0,0,0,0,0,0,0,0,0,2018
3,20304,OO,OO,SkyWest Airlines Inc.,3,8110361,0,0,0,0,8110361,8110361,0,8110361,18506574,0,0,0,0,18506574,18506574,0,18506574,2018
3,20177,PFQ,PFQ,Asia Pacific,1,0,0,0,0,0,0,0,312777,312777,0,0,0,0,0,0,0,744422,744422,2018
3,20100,PO,PO,Polar Air Cargo Airways,3,3130492,925977,12907318,0,13833295,16963787,3130492,13833295,16963787,6131631,2185194,24802994,0,26988188,33119819,6131631,26988188,33119819,2018
3,19687,QX,QX,Horizon Air,2,0,0,0,0,0,0,0,0,0,0,0,0,0,0,0,0,0,0,2018
3,20422,SY,SY,Sun Country Airlines d/b/a MN Airlines,2,3383189,0,0,2471419,2471419,5854608,4126989,2522333,6649322,7078478,0,0,5570636,5570636,12649114,9947664,5680068,15627732,2018
3,20447,U7,U7,USA Jet Airlines Inc.,2,0,0,0,0,0,0,650659,28862,679521,0,0,0,0,0,0,1263170,98777,1361947,2018
3,19977,UA,UA,United Air Lines Inc.,3,134540010,54703635,55557792,33298314,143559741,278099751,135411162,143911573,279322735,260560325,107857199,111449674,68136689,287443562,548003887,262245488,288171799,550417287,2018
3,20195,WI,WI,Sky Lease Cargo,1,0,0,0,0,0,0,38845,2070544,2109389,0,0,0,0,0,0,91478,4469852,4561330,2018
3,20310,WL,WL,"Caribbean Sun Airlines, Inc. d/b/a World Atlantic Airlines",1,0,0,0,0,0,0,20224,26090,46314,0,0,0,0,0,0,58402,75342,133744,2018
3,20377,X9,X9,Omni Air International LLC,2,0,0,0,0,0,0,435588,3223535,3659123,0,0,0,0,0,0,911363,6997349,7908712,2018
3,20207,XP,XP,XTRA Airways,1,0,0,0,0,0,0,376436,126305,502741,0,0,0,0,0,0,915159,555094,1470253,2018
3,20378,YV,YV,Mesa Airlines Inc.,2,0,0,0,0,0,0,0,0,0,0,0,0,0,0,0,0,0,0,2018
3,20452,YX,YX,Republic Airline,2,21202,0,0,0,0,21202,21202,0,21202,48320,0,0,0,0,48320,48320,0,48320,2018
3,19393,WN,WN,Southwest Airlines Co.,3,176770081,0,0,2506139,2506139,179276220,177101321,2506139,179607460,345317146,0,0,5805615,5805615,351122761,345962204,5805615,351767819,2018
4,21161,09Q,09Q,"Swift Air, LLC d/b/a Eastern Air Lines d/b/a Eastern",1,0,0,0,0,0,0,360612,758739,1119351,0,0,0,0,0,0,1094419,2391916,3486335,2018
4,21352,0WQ,0WQ,Avjet Corporation,1,0,0,0,0,0,0,0,0,0,0,0,0,0,0,0,0,0,0,2018
4,21492,1BQ,1BQ,"Eastern Airlines f/k/a Dynamic Airways, LLC",1,0,0,0,0,0,0,4730,101596,106326,0,0,0,0,0,0,11009,324234,335243,2018
4,21652,27Q,27Q,"Jet Aviation Flight Services, Inc.",1,0,0,0,0,0,0,0,0,0,0,0,0,0,0,0,0,0,0,2018
4,21712,2HQ,2HQ,Elite Airways LLC,1,217261,0,0,0,0,217261,362690,0,362690,960151,0,0,0,0,960151,1512475,0,1512475,2018
4,20408,5V,5V,Tatonduk Outfitters Limited d/b/a Everts Air Alaska and Everts Air Cargo,1,300687,0,0,0,0,300687,339627,0,339627,818390,0,0,0,0,818390,924374,0,924374,2018
4,19917,5X,5X,United Parcel Service,3,37224000,11824000,16873000,3088000,31785000,69009000,37224000,31785000,69009000,76798000,24109000,34293000,6767000,65169000,141967000,76798000,65169000,141967000,2018
4,20007,5Y,5Y,Atlas Air Inc.,3,0,0,0,0,0,0,11523920,31439983,42963903,0,0,0,0,0,0,23653993,65731929,89385922,2018
4,19874,8C,8C,Air Transport International,2,0,0,0,0,0,0,30031,591451,621482,0,0,0,0,0,0,84993,1264039,1349032,2018
4,20363,9E,9E,Endeavor Air Inc.,2,0,0,0,0,0,0,0,0,0,0,0,0,0,0,0,0,0,0,2018
4,20190,9S,9S,Southern Air Inc.,2,746246,1675226,3415277,14043,5104546,5850792,746246,5104546,5850792,1530117,3567407,7086795,29979,10684181,12214298,1530117,10684181,12214298,2018
4,19805,AA,AA,American Airlines Inc.,3,176468697,51179339,22496487,46909471,120585297,297053994,177072576,120711716,297784292,347767028,105289745,45566263,98660138,249516146,597283174,348977443,249795156,598772599,2018
4,20453,ABX,ABX,ABX Air Inc,2,163281,0,0,0,0,163281,163281,0,163281,488129,0,0,0,0,488129,488129,0,488129,2018
4,19930,AS,AS,Alaska Airlines Inc.,3,59350238,0,0,1353204,1353204,60703442,59465945,1353204,60819149,132713732,0,0,3253819,3253819,135967551,132949288,3253819,136203107,2018
4,20409,B6,B6,JetBlue Airways,3,57303758,0,0,13174204,13174204,70477962,57303758,13174204,70477962,124606964,0,0,28647292,28647292,153254256,124606964,28647292,153254256,2018
4,21167,CP,CP,Compass Airlines,2,0,0,0,0,0,0,0,0,0,0,0,0,0,0,0,0,0,0,2018
4,19790,DL,DL,Delta Air Lines Inc.,3,170927843,58989025,28253409,25686058,112928492,283856335,172728275,113091077,285819352,371620292,128250134,61426740,55844971,245521845,617142137,376793506,245875326,622668832,2018
4,20366,EV,EV,ExpressJet Airlines Inc.,3,0,0,0,0,0,0,0,0,0,0,0,0,0,0,0,0,0,0,2018
4,20436,F9,F9,Frontier Airlines Inc.,3,18646834,0,0,2442530,2442530,21089364,18646834,2442530,21089364,37389461,0,0,5101802,5101802,42491263,37389461,5101802,42491263,2018
4,20107,FX,FX,Federal Express Corporation,3,55570820,12960650,20407941,1952245,35320836,90891656,56876696,36198386,93075082,113522000,27018000,41650000,4244000,72912000,186434000,116259221,74810000,191069221,2018
4,20368,G4,G4,Allegiant Air,3,16057625,0,0,0,0,16057625,16502924,140183,16643107,36469135,0,0,0,0,36469135,37508105,346096,37854201,2018
4,20500,G7,G7,GoJet Airlines LLC d/b/a United Express,2,0,0,0,0,0,0,0,0,0,0,0,0,0,0,0,0,0,0,2018
4,20166,GFQ,GFQ,Gulf And Caribbean Cargo,1,0,0,0,0,0,0,212750,149750,362500,0,0,0,0,0,0,547695,417358,965053,2018
4,20402,GL,GL,Miami Air International,2,0,0,0,0,0,0,250019,360383,610402,0,0,0,0,0,0,670576,966586,1637162,2018
4,19690,HA,HA,Hawaiian Airlines Inc.,3,15068216,0,7199289,0,7199289,22267505,15068216,7199289,22267505,31211656,0,14585448,0,14585448,45797104,31211656,14585448,45797104,2018
4,20370,KAQ,KAQ,Kalitta Air LLC,2,0,0,0,0,0,0,1290207,4404596,5694803,0,0,0,0,0,0,2714546,10330000,13044546,2018
4,21629,KD,KD,Western Global,1,0,0,0,0,0,0,1203716,839063,2042779,0,0,0,0,0,0,2675378,1886981,4562359,2018
4,21634,KH,KH,Aloha Air Cargo,1,385347,0,0,0,0,385347,385347,0,385347,801374,0,0,0,0,801374,801374,0,801374,2018
4,20372,KLQ,KLQ,Kalitta Charters II,1,0,0,0,0,0,0,68914,75262,144176,0,0,0,0,0,0,200638,194349,394987,2018
4,20169,L2,L2,Lynden Air Cargo Airlines,1,89380,0,0,0,0,89380,163924,32299,196223,211983,0,0,0,0,211983,392094,99688,491782,2018
4,20151,M6,M6,Amerijet International,2,0,0,0,1356211,1356211,1356211,333582,1692987,2026569,0,0,0,3099461,3099461,3099461,762363,3869123,4631486,2018
4,20398,MQ,MQ,Envoy Air,3,0,0,0,0,0,0,0,0,0,0,0,0,0,0,0,0,0,0,2018
4,20405,N8,N8,National Air Cargo Group Inc d/ba National Airlines,1,0,0,0,0,0,0,56922,987648,1044570,0,0,0,0,0,0,202399,4368885,4571284,2018
4,20108,NC,NC,Northern Air Cargo Inc.,1,,,,,,,,,,736103,,,,,736103,951577,,970195,2018
4,20416,NK,NK,Spirit Air Lines,3,30762732,0,0,3229237,3229237,33991969,30762732,3229237,33991969,67232336,0,0,7057538,7057538,74289874,67232336,7057538,74289874,2018
4,20397,OH,OH,PSA Airlines Inc.,2,0,0,0,0,0,0,0,0,0,0,0,0,0,0,0,0,0,0,2018
4,20304,OO,OO,SkyWest Airlines Inc.,3,7897373,0,0,0,0,7897373,7897373,0,7897373,18718245,0,0,0,0,18718245,18718245,0,18718245,2018
4,20177,PFQ,PFQ,Asia Pacific,1,0,0,0,0,0,0,0,280011,280011,0,0,0,0,0,0,0,642855,642855,2018
4,20100,PO,PO,Polar Air Cargo Airways,3,3054470,717166,11505969,0,12223135,15277605,3054470,12223135,15277605,6373880,1760308,22421293,0,24181601,30555481,6373880,24181601,30555481,2018
4,19687,QX,QX,Horizon Air,2,0,0,0,0,0,0,0,0,0,0,0,0,0,0,0,0,0,0,2018
4,20422,SY,SY,Sun Country Airlines d/b/a MN Airlines,2,3254566,0,0,1076773,1076773,4331339,3792102,1180935,4973037,7224128,0,0,2561762,2561762,9785890,9426108,2779404,12205512,2018
4,20447,U7,U7,USA Jet Airlines Inc.,2,0,0,0,0,0,0,352176,14760,366936,0,0,0,0,0,0,725750,57883,783633,2018
4,19977,UA,UA,United Air Lines Inc.,3,137000974,58942182,50977138,30101170,140020490,277021464,137776920,140296801,278073721,279219252,120581748,103947624,63412940,287942312,567161564,280800266,288504684,569304950,2018
4,20195,WI,WI,Sky Lease Cargo,1,0,0,0,0,0,0,0,1738290,1738290,0,0,0,0,0,0,0,3975420,3975420,2018
4,20310,WL,WL,"Caribbean Sun Airlines, Inc. d/b/a World Atlantic Airlines",1,0,0,0,0,0,0,30015,22448,52463,0,0,0,0,0,0,82257,61520,143777,2018
4,20377,X9,X9,Omni Air International LLC,2,0,0,0,0,0,0,465832,3296346,3762178,0,0,0,0,0,0,1114153,6898749,8012902,2018
4,20207,XP,XP,XTRA Airways,1,0,0,0,0,0,0,180237,82845,263082,0,0,0,0,0,0,135164,172961,308125,2018
4,20378,YV,YV,Mesa Airlines Inc.,2,0,0,0,0,0,0,0,0,0,0,0,0,0,0,0,0,0,0,2018
4,20452,YX,YX,Republic Airline,2,33454,0,0,0,0,33454,33454,0,33454,81246,0,0,0,0,81246,81246,0,81246,2018
4,19393,WN,WN,Southwest Airlines Co.,3,174522477,0,0,1928657,1928657,176451134,174739867,1928657,176668524,348976261,0,0,4712631,4712631,353688892,349419128,4712631,354131759,2018
5,21161,09Q,09Q,"Swift Air, LLC d/b/a Eastern Air Lines d/b/a Eastern",1,0,0,0,0,0,0,336027,639513,975540,0,0,0,0,0,0,925090,1476670,2401760,2018
5,21352,0WQ,0WQ,Avjet Corporation,1,0,0,0,0,0,0,0,0,0,0,0,0,0,0,0,0,0,0,2018
5,21492,1BQ,1BQ,"Eastern Airlines f/k/a Dynamic Airways, LLC",1,0,0,0,0,0,0,10043,119954,129997,0,0,0,0,0,0,44204,367491,411695,2018
5,21652,27Q,27Q,"Jet Aviation Flight Services, Inc.",1,0,0,0,0,0,0,0,0,0,0,0,0,0,0,0,0,0,0,2018
5,21712,2HQ,2HQ,Elite Airways LLC,1,147260,0,0,0,0,147260,304165,0,304165,781692,0,0,0,0,781692,1414964,0,1414964,2018
5,20408,5V,5V,Tatonduk Outfitters Limited d/b/a Everts Air Alaska and Everts Air Cargo,1,288218,0,0,0,0,288218,338685,0,338685,919764,0,0,0,0,919764,1080815,0,1080815,2018
5,19917,5X,5X,United Parcel Service,3,40872000,12573000,17857000,3336000,33766000,74638000,40872000,33766000,74638000,90238000,27508000,38880000,7753000,74141000,164379000,90238000,74141000,164379000,2018
5,20007,5Y,5Y,Atlas Air Inc.,3,0,0,0,0,0,0,12439660,34340069,46779729,0,0,0,0,0,0,28545465,79143725,107689190,2018
5,19874,8C,8C,Air Transport International,2,0,0,0,0,0,0,27986,600915,628901,0,0,0,0,0,0,92081,1543022,1635103,2018
5,20363,9E,9E,Endeavor Air Inc.,2,0,0,0,0,0,0,0,0,0,0,0,0,0,0,0,0,0,0,2018
5,20190,9S,9S,Southern Air Inc.,2,785893,1731758,3854182,0,5585940,6371833,785893,5585940,6371833,1833948,4351650,9042721,0,13394371,15228319,1833948,13394371,15228319,2018
5,19805,AA,AA,American Airlines Inc.,3,186106245,62265586,22728524,46970482,131964592,318070837,186850065,132104815,318954880,393997862,137128182,48973657,106109616,292211455,686209317,395581378,292526294,688107672,2018
5,20453,ABX,ABX,ABX Air Inc,2,196691,0,0,0,0,196691,196691,0,196691,497628,0,0,0,0,497628,497628,0,497628,2018
5,19930,AS,AS,Alaska Airlines Inc.,3,61933139,0,0,1114398,1114398,63047537,62005379,1114398,63119777,147844556,0,0,2859173,2859173,150703729,148001060,2859173,150860233,2018
5,20409,B6,B6,JetBlue Airways,3,59886378,0,0,12806070,12806070,72692448,59886993,12806070,72693063,140044856,0,0,29947114,29947114,169991970,140046184,29947114,169993298,2018
5,21167,CP,CP,Compass Airlines,2,0,0,0,0,0,0,0,0,0,0,0,0,0,0,0,0,0,0,2018
5,19790,DL,DL,Delta Air Lines Inc.,3,179707450,72323728,29951565,24469943,126745236,306452686,180873427,126783203,307656630,379472769,152719798,63246145,51671075,267637018,647109787,383353725,267717190,651070915,2018
5,20366,EV,EV,ExpressJet Airlines Inc.,3,0,0,0,0,0,0,0,0,0,0,0,0,0,0,0,0,0,0,2018
5,20436,F9,F9,Frontier Airlines Inc.,3,19729113,0,0,2586309,2586309,22315422,19729113,2586309,22315422,43177126,0,0,5774199,5774199,48951325,43177126,5774199,48951325,2018
5,20107,FX,FX,Federal Express Corporation,3,59628554,14093696,21968679,2108696,38171071,97799625,60949705,39306065,100255770,130734000,31468000,48151000,4951000,84570000,215304000,133676000,87145000,220821000,2018
5,20368,G4,G4,Allegiant Air,3,15471117,0,0,0,0,15471117,15978484,151542,16130026,37596855,0,0,0,0,37596855,38868258,393536,39261794,2018
5,20500,G7,G7,GoJet Airlines LLC d/b/a United Express,2,0,0,0,0,0,0,0,0,0,0,0,0,0,0,0,0,0,0,2018
5,20166,GFQ,GFQ,Gulf And Caribbean Cargo,1,0,0,0,0,0,0,185750,162324,348074,0,0,0,0,0,0,500016,459580,959596,2018
5,20402,GL,GL,Miami Air International,2,0,0,0,0,0,0,225643,250478,476121,0,0,0,0,0,0,674436,748667,1423103,2018
5,19690,HA,HA,Hawaiian Airlines Inc.,3,15757332,0,7277516,0,7277516,23034848,15757332,7277516,23034848,34682245,0,15762395,0,15762395,50444640,34682245,15762395,50444640,2018
5,20370,KAQ,KAQ,Kalitta Air LLC,2,0,0,0,0,0,0,1293455,4717202,6010657,0,0,0,0,0,0,2886417,11698585,14585002,2018
5,21629,KD,KD,Western Global,1,0,0,0,0,0,0,1074307,736477,1810784,0,0,0,0,0,0,2552822,1724513,4277335,2018
5,21634,KH,KH,Aloha Air Cargo,1,404001,0,0,0,0,404001,404001,0,404001,895108,0,0,0,0,895108,895108,0,895108,2018
5,20372,KLQ,KLQ,Kalitta Charters II,1,0,0,0,0,0,0,69347,88908,158255,0,0,0,0,0,0,206228,251595,457823,2018
5,20169,L2,L2,Lynden Air Cargo Airlines,1,96966,0,0,0,0,96966,231258,68628,299886,254929,0,0,0,0,254929,632265,234267,866532,2018
5,20151,M6,M6,Amerijet International,2,0,0,0,1434445,1434445,1434445,387194,1598176,1985370,0,0,0,3421149,3421149,3421149,923457,3811647,4735104,2018
5,20398,MQ,MQ,Envoy Air,3,0,0,0,0,0,0,0,0,0,0,0,0,0,0,0,0,0,0,2018
5,20405,N8,N8,National Air Cargo Group Inc d/ba National Airlines,1,0,0,0,0,0,0,15007,1140693,1155700,0,0,0,0,0,0,73617,4872103,4945720,2018
5,20108,NC,NC,Northern Air Cargo Inc.,1,333623,0,0,0,0,333623,445143,4033,449176,799698,0,0,0,0,799698,1033301,9581,1042882,2018
5,20416,NK,NK,Spirit Air Lines,3,32005287,0,0,3516674,3516674,35521961,32005287,3516674,35521961,76289755,0,0,8382559,8382559,84672314,76289755,8382559,84672314,2018
5,20397,OH,OH,PSA Airlines Inc.,2,0,0,0,0,0,0,0,0,0,0,0,0,0,0,0,0,0,0,2018
5,20304,OO,OO,SkyWest Airlines Inc.,3,8257547,0,0,0,0,8257547,8257547,0,8257547,21498760,0,0,0,0,21498760,21498760,0,21498760,2018
5,20177,PFQ,PFQ,Asia Pacific,1,0,0,0,0,0,0,0,323522,323522,0,0,0,0,0,0,0,802254,802254,2018
5,20100,PO,PO,Polar Air Cargo Airways,3,3039835,741953,12146812,0,12888765,15928600,3039835,12888765,15928600,6765516,1879943,25391506,0,27271449,34036965,6765516,27271449,34036965,2018
5,19687,QX,QX,Horizon Air,2,0,0,0,0,0,0,0,0,0,0,0,0,0,0,0,0,0,0,2018
5,20422,SY,SY,Sun Country Airlines d/b/a MN Airlines,2,3176000,0,0,315643,315643,3491643,3643739,453014,4096753,7507507,0,0,791759,791759,8299266,9998142,1041563,11039705,2018
5,20447,U7,U7,USA Jet Airlines Inc.,2,0,0,0,0,0,0,459014,20606,479620,0,0,0,0,0,0,1026332,69879,1096211,2018
5,19977,UA,UA,United Air Lines Inc.,3,144733258,71171452,53160067,26379967,150711486,295444744,145503793,150907996,296411789,314823949,155296421,115496674,59778228,330571323,645395272,316490599,331008555,647499154,2018
5,20195,WI,WI,Sky Lease Cargo,1,0,0,0,0,0,0,0,2604629,2604629,0,0,0,0,0,0,0,6191757,6191757,2018
5,20310,WL,WL,"Caribbean Sun Airlines, Inc. d/b/a World Atlantic Airlines",1,0,0,0,0,0,0,51134,27522,78656,0,0,0,0,0,0,180704,97261,277965,2018
5,20377,X9,X9,Omni Air International LLC,2,0,0,0,0,0,0,393393,3288877,3682270,0,0,0,0,0,0,885184,8421779,9306963,2018
5,20207,XP,XP,XTRA Airways,1,0,0,0,0,0,0,121365,6908,128273,0,0,0,0,0,0,33726,32483,66209,2018
5,20378,YV,YV,Mesa Airlines Inc.,2,0,0,0,0,0,0,0,0,0,0,0,0,0,0,0,0,0,0,2018
5,20452,YX,YX,Republic Airline,2,30609,0,0,0,0,30609,30609,0,30609,76833,0,0,0,0,76833,76833,0,76833,2018
5,19393,WN,WN,Southwest Airlines Co.,3,179255111,0,0,2389534,2389534,181644645,179450601,2389534,181840135,379119974,0,0,6220628,6220628,385340602,379542553,6220628,385763181,2018
6,21161,09Q,09Q,"Swift Air, LLC d/b/a Eastern Air Lines d/b/a Eastern",1,0,0,0,0,0,0,455832,1083634,1539466,0,0,0,0,0,0,1152212,2228996,3381208,2018
6,21352,0WQ,0WQ,Avjet Corporation,1,0,0,0,0,0,0,0,0,0,0,0,0,0,0,0,0,0,0,2018
6,21492,1BQ,1BQ,"Eastern Airlines f/k/a Dynamic Airways, LLC",1,0,0,0,0,0,0,3678,101329,105007,0,0,0,0,0,0,11202,231082,242284,2018
6,21652,27Q,27Q,"Jet Aviation Flight Services, Inc.",1,0,0,0,0,0,0,0,0,0,0,0,0,0,0,0,0,0,0,2018
6,21712,2HQ,2HQ,Elite Airways LLC,1,89988,0,0,0,0,89988,462132,0,462132,252948,0,0,0,0,252948,1785814,0,1785814,2018
6,20408,5V,5V,Tatonduk Outfitters Limited d/b/a Everts Air Alaska and Everts Air Cargo,1,356456,0,0,0,0,356456,426779,0,426779,1027698,0,0,0,0,1027698,1228754,0,1228754,2018
6,19917,5X,5X,United Parcel Service,3,38045000,11544000,17332000,2862000,31738000,69783000,38045000,31738000,69783000,83367000,25551000,38974000,6630000,71155000,154522000,83367000,71155000,154522000,2018
6,20007,5Y,5Y,Atlas Air Inc.,3,0,0,0,0,0,0,11988906,33668801,45657707,0,0,0,0,0,0,26813120,78527340,105340460,2018
6,19874,8C,8C,Air Transport International,2,0,0,0,0,0,0,26307,557112,583419,0,0,0,0,0,0,84142,1388716,1472858,2018
6,20363,9E,9E,Endeavor Air Inc.,2,0,0,0,0,0,0,0,0,0,0,0,0,0,0,0,0,0,0,2018
6,20190,9S,9S,Southern Air Inc.,2,844492,1706612,0,6164576,7871188,8715680,844492,7871188,8715680,1909370,4305342,0,14814812,19120154,21029524,1909370,19120154,21029524,2018
6,19805,AA,AA,American Airlines Inc.,3,191942315,64232934,22781389,47708094,134722417,326664732,192398584,134879165,327277749,413054909,140545702,49883726,110748337,301177765,714232674,414037019,301536312,715573331,2018
6,20453,ABX,ABX,ABX Air Inc,2,175886,0,0,0,0,175886,175886,0,175886,490722,0,0,0,0,490722,490722,0,490722,2018
6,19930,AS,AS,Alaska Airlines Inc.,3,63117807,0,0,1028251,1028251,64146058,63201373,1028251,64229624,149466966,0,0,2654738,2654738,152121704,149647804,2654738,152302542,2018
6,20409,B6,B6,JetBlue Airways,3,58339731,0,0,13742251,13742251,72081982,58339731,13742251,72081982,135866314,0,0,32004074,32004074,167870388,135866314,32004074,167870388,2018
6,21167,CP,CP,Compass Airlines,2,0,0,0,0,0,0,0,0,0,0,0,0,0,0,0,0,0,0,2018
6,19790,DL,DL,Delta Air Lines Inc.,3,189495124,80318068,30101654,24307025,134726747,324221871,190645694,134726747,325372441,410200016,173864488,65161038,52617408,291642934,701842950,414219712,291642934,705862646,2018
6,20366,EV,EV,ExpressJet Airlines Inc.,3,0,0,0,0,0,0,0,0,0,0,0,0,0,0,0,0,0,0,2018
6,20436,F9,F9,Frontier Airlines Inc.,3,19559991,0,0,2536796,2536796,22096787,19559991,2536796,22096787,41775934,0,0,5704097,5704097,47480031,41775934,5704097,47480031,2018
6,20107,FX,FX,Federal Express Corporation,3,57854765,13755698,21753419,2012216,37521333,95376098,59105226,38675088,97780314,125383000,30437000,48924000,4909000,84270000,209653000,128130000,86904000,215034000,2018
6,20368,G4,G4,Allegiant Air,3,18141824,0,0,0,0,18141824,18589560,153122,18742682,43754907,0,0,0,0,43754907,44832095,394270,45226365,2018
6,20500,G7,G7,GoJet Airlines LLC d/b/a United Express,2,0,0,0,0,0,0,0,0,0,0,0,0,0,0,0,0,0,0,2018
6,20166,GFQ,GFQ,Gulf And Caribbean Cargo,1,0,0,0,0,0,0,200524,143257,343781,0,0,0,0,0,0,571097,410559,981656,2018
6,20402,GL,GL,Miami Air International,2,0,0,0,0,0,0,257916,342335,600251,0,0,0,0,0,0,744652,988387,1733039,2018
6,19690,HA,HA,Hawaiian Airlines Inc.,3,15996680,0,7320839,0,7320839,23317519,15996680,7320839,23317519,34893933,0,16132250,0,16132250,51026183,34893933,16132250,51026183,2018
6,20370,KAQ,KAQ,Kalitta Air LLC,2,0,0,0,0,0,0,1288732,4835893,6124625,0,0,0,0,0,0,2926777,12321168,15247945,2018
6,21629,KD,KD,Western Global,1,0,0,0,0,0,0,1340108,923665,2263773,0,0,0,0,0,0,3338364,2239114,5577478,2018
6,21634,KH,KH,Aloha Air Cargo,1,385855,0,0,0,0,385855,385855,0,385855,846007,0,0,0,0,846007,846007,0,846007,2018
6,20372,KLQ,KLQ,Kalitta Charters II,1,0,0,0,0,0,0,91082,70662,161744,0,0,0,0,0,0,259109,190382,449491,2018
6,20169,L2,L2,Lynden Air Cargo Airlines,1,99671,0,0,0,0,99671,260741,36616,297357,263266,0,0,0,0,263266,680842,124861,805703,2018
6,20151,M6,M6,Amerijet International,2,0,0,0,1335025,1335025,1335025,348060,1493294,1841354,0,0,0,3171208,3171208,3171208,826779,3547159,4373938,2018
6,20398,MQ,MQ,Envoy Air,3,0,0,0,0,0,0,0,0,0,0,0,0,0,0,0,0,0,0,2018
6,20405,N8,N8,National Air Cargo Group Inc d/ba National Airlines,1,0,0,0,0,0,0,9499,1374895,1384394,0,0,0,0,0,0,39743,3766023,3805766,2018
6,20108,NC,NC,Northern Air Cargo Inc.,1,367314,0,0,0,0,367314,532920,0,532920,851998,0,0,0,0,851998,1226285,0,1226285,2018
6,20416,NK,NK,Spirit Air Lines,3,33039956,0,0,3589707,3589707,36629663,33039956,3589707,36629663,78670516,0,0,8547351,8547351,87217867,78670516,8547351,87217867,2018
6,20397,OH,OH,PSA Airlines Inc.,2,0,0,0,0,0,0,0,0,0,0,0,0,0,0,0,0,0,0,2018
6,20304,OO,OO,SkyWest Airlines Inc.,3,8108076,0,0,0,0,8108076,8108076,0,8108076,20726835,0,0,0,0,20726835,20726835,0,20726835,2018
6,20177,PFQ,PFQ,Asia Pacific,1,0,0,0,0,0,0,0,259521,259521,0,0,0,0,0,0,0,661072,661072,2018
6,20100,PO,PO,Polar Air Cargo Airways,3,3154774,718048,11818714,0,12536762,15691536,3154774,12536762,15691536,6948780,1785653,25948739,0,27734392,34683172,6948780,27734392,34683172,2018
6,19687,QX,QX,Horizon Air,2,0,0,0,0,0,0,0,0,0,0,0,0,0,0,0,0,0,0,2018
6,20422,SY,SY,Sun Country Airlines d/b/a MN Airlines,2,3631156,0,0,810677,810677,4441833,4236152,828005,5064157,8557540,0,0,2078999,2078999,10636539,11226859,2126852,13353711,2018
6,20447,U7,U7,USA Jet Airlines Inc.,2,0,0,0,0,0,0,525448,58634,584082,0,0,0,0,0,0,1163873,206562,1370435,2018
6,19977,UA,UA,United Air Lines Inc.,3,154057193,74378497,51889734,29820882,156089113,310146306,154622048,156605254,311227302,335404346,164146251,115949116,68959417,349054784,684459130,336639088,350209934,686849022,2018
6,20195,WI,WI,Sky Lease Cargo,1,0,0,0,0,0,0,0,1193725,1193725,0,0,0,0,0,0,0,2852105,2852105,2018
6,20310,WL,WL,"Caribbean Sun Airlines, Inc. d/b/a World Atlantic Airlines",1,0,0,0,0,0,0,62239,139716,201955,0,0,0,0,0,0,144023,323307,467330,2018
6,20377,X9,X9,Omni Air International LLC,2,0,0,0,0,0,0,385818,3608749,3994567,0,0,0,0,0,0,948904,8673139,9622043,2018
6,20207,XP,XP,XTRA Airways,1,0,0,0,0,0,0,0,0,0,0,0,0,0,0,0,0,0,0,2018
6,20378,YV,YV,Mesa Airlines Inc.,2,0,0,0,0,0,0,0,0,0,0,0,0,0,0,0,0,0,0,2018
6,20452,YX,YX,Republic Airline,2,13447,0,0,0,0,13447,13447,2307,15754,35171,0,0,0,0,35171,35171,12043,47214,2018
6,19393,WN,WN,Southwest Airlines Co.,3,181821721,0,0,2965799,2965799,184787520,182164105,2965799,185129904,394590744,0,0,7725539,7725539,402316283,395344788,7725539,403070327,2018
7,21161,09Q,09Q,"Swift Air, LLC d/b/a Eastern Air Lines d/b/a Eastern",1,0,0,0,0,0,0,282098,810093,1092191,0,0,0,0,0,0,1086568,2607574,3694142,2018
7,21352,0WQ,0WQ,Avjet Corporation,1,0,0,0,0,0,0,0,0,0,0,0,0,0,0,0,0,0,0,2018
7,21492,1BQ,1BQ,"Eastern Airlines f/k/a Dynamic Airways, LLC",1,0,0,0,0,0,0,34508,99226,133734,0,0,0,0,0,0,90739,385100,475839,2018
7,21652,27Q,27Q,"Jet Aviation Flight Services, Inc.",1,0,0,0,0,0,0,0,0,0,0,0,0,0,0,0,0,0,0,2018
7,21712,2HQ,2HQ,Elite Airways LLC,1,166813,0,0,0,0,166813,210465,0,210465,699027,0,0,0,0,699027,866130,0,866130,2018
7,20408,5V,5V,Tatonduk Outfitters Limited d/b/a Everts Air Alaska and Everts Air Cargo,1,415996,0,0,0,0,415996,486124,0,486124,1151583,0,0,0,0,1151583,1345715,0,1345715,2018
7,19917,5X,5X,United Parcel Service,3,39026000,11469000,18420000,2960000,32849000,71875000,39026000,32849000,71875000,84786000,24821000,40316000,6825000,71962000,156748000,84786000,71962000,156748000,2018
7,20007,5Y,5Y,Atlas Air Inc.,3,0,0,0,0,0,0,11090055,32488053,43578108,0,0,0,0,0,0,24787334,72273736,97061070,2018
7,19874,8C,8C,Air Transport International,2,0,0,0,0,0,0,38606,610837,649443,0,0,0,0,0,0,123732,1510631,1634363,2018
7,20363,9E,9E,Endeavor Air Inc.,2,0,0,0,0,0,0,0,0,0,0,0,0,0,0,0,0,0,0,2018
7,20190,9S,9S,Southern Air Inc.,2,803097,1991253,6720044,20609,8731906,9535003,803097,8731906,9535003,1810846,4941764,15230732,48777,20221273,22032119,1810846,20221273,22032119,2018
7,19805,AA,AA,American Airlines Inc.,3,200042968,67329061,23027563,49779586,140136210,340179178,200585393,140497057,341082450,423967100,146275520,49829459,113685180,309790159,733757259,425117748,310608798,735726546,2018
7,20453,ABX,ABX,ABX Air Inc,2,183134,0,0,0,0,183134,183134,0,183134,448385,0,0,0,0,448385,448385,0,448385,2018
7,19930,AS,AS,Alaska Airlines Inc.,3,65512286,0,0,1043539,1043539,66555825,65575153,1043539,66618692,154217039,0,0,2646043,2646043,156863082,154352671,2646043,156998714,2018
7,20409,B6,B6,JetBlue Airways,3,60437078,0,0,16444241,16444241,76881319,60441448,16444241,76885689,139028436,0,0,37828054,37828054,176856490,139038615,37828054,176866669,2018
7,21167,CP,CP,Compass Airlines,2,0,0,0,0,0,0,0,0,0,0,0,0,0,0,0,0,0,0,2018
7,19790,DL,DL,Delta Air Lines Inc.,3,200213045,84099095,32711580,25557523,142368198,342581243,201400497,142368198,343768695,451143804,189502066,73709616,57589246,320800928,771944732,455203610,320800928,776004538,2018
7,20366,EV,EV,ExpressJet Airlines Inc.,3,0,0,0,0,0,0,0,0,0,0,0,0,0,0,0,0,0,0,2018
7,20436,F9,F9,Frontier Airlines Inc.,3,20252343,0,0,2167454,2167454,22419797,20252343,2167454,22419797,38710762,0,0,4509877,4509877,43220639,38710762,4509877,43220639,2018
7,20107,FX,FX,Federal Express Corporation,3,54935375,13516776,21664764,1892088,37073628,92009003,56301492,38191922,94493414,118291000,29426000,47557000,4597000,81580000,199871000,121269514,84148798,205418312,2018
7,20368,G4,G4,Allegiant Air,3,19383056,0,0,0,0,19383056,19798809,151509,19950318,46333842,0,0,0,0,46333842,47317777,386326,47704103,2018
7,20500,G7,G7,GoJet Airlines LLC d/b/a United Express,2,0,0,0,0,0,0,0,0,0,0,0,0,0,0,0,0,0,0,2018
7,20166,GFQ,GFQ,Gulf And Caribbean Cargo,1,0,0,0,0,0,0,127012,95305,222317,0,0,0,0,0,0,366251,281293,647544,2018
7,20402,GL,GL,Miami Air International,2,0,0,0,0,0,0,175250,269092,444342,0,0,0,0,0,0,498227,765015,1263242,2018
7,19690,HA,HA,Hawaiian Airlines Inc.,3,16483215,0,7612779,0,7612779,24095994,16483215,7612779,24095994,35609790,0,16437310,0,16437310,52047100,35609790,16437310,52047100,2018
7,20370,KAQ,KAQ,Kalitta Air LLC,2,0,0,0,0,0,0,1289157,4893706,6182863,0,0,0,0,0,0,2939615,11921493,14861108,2018
7,21629,KD,KD,Western Global,1,0,0,0,0,0,0,2610708,1026402,3637110,0,0,0,0,0,0,6165686,2420964,8586650,2018
7,21634,KH,KH,Aloha Air Cargo,1,380174,0,0,0,0,380174,380174,0,380174,822598,0,0,0,0,822598,822598,0,822598,2018
7,20372,KLQ,KLQ,Kalitta Charters II,1,0,0,0,0,0,0,94534,24921,119455,0,0,0,0,0,0,277451,66807,344258,2018
7,20169,L2,L2,Lynden Air Cargo Airlines,1,107974,0,0,0,0,107974,290306,7076,297382,295599,0,0,0,0,295599,756669,21588,778257,2018
7,20151,M6,M6,Amerijet International,2,0,0,0,1337760,1337760,1337760,309522,1442626,1752148,0,0,0,3151433,3151433,3151433,729157,3398471,4127628,2018
7,20398,MQ,MQ,Envoy Air,3,0,0,0,0,0,0,0,0,0,0,0,0,0,0,0,0,0,0,2018
7,20405,N8,N8,National Air Cargo Group Inc d/ba National Airlines,1,0,0,0,0,0,0,0,1176339,1176339,0,0,0,0,0,0,0,3077015,3077015,2018
7,20108,NC,NC,Northern Air Cargo Inc.,1,397307,0,0,0,0,397307,556701,0,556701,914387,0,0,0,0,914387,1279177,0,1279177,2018
7,20416,NK,NK,Spirit Air Lines,3,35033773,0,0,3763318,3763318,38797091,35033773,3763318,38797091,82463340,0,0,8858188,8858188,91321528,82463340,8858188,91321528,2018
7,20397,OH,OH,PSA Airlines Inc.,2,0,0,0,0,0,0,0,0,0,0,0,0,0,0,0,0,0,0,2018
7,20304,OO,OO,SkyWest Airlines Inc.,3,8254370,0,0,0,0,8254370,8254370,0,8254370,20894688,0,0,0,0,20894688,20894688,0,20894688,2018
7,20177,PFQ,PFQ,Asia Pacific,1,0,0,0,0,0,0,0,305634,305634,0,0,0,0,0,0,0,764046,764046,2018
7,20100,PO,PO,Polar Air Cargo Airways,3,3269559,830619,12508485,0,13339104,16608663,3269559,13339104,16608663,7284407,2045885,26749554,0,28795439,36079846,7284407,28795439,36079846,2018
7,19687,QX,QX,Horizon Air,2,0,0,0,0,0,0,0,0,0,0,0,0,0,0,0,0,0,0,2018
7,20422,SY,SY,Sun Country Airlines d/b/a MN Airlines,2,4285650,0,0,739589,739589,5025239,4589692,798546,5388238,9949034,0,0,1860654,1860654,11809688,11699946,1937632,13637578,2018
7,20447,U7,U7,USA Jet Airlines Inc.,2,0,0,0,0,0,0,482696,35546,518242,0,0,0,0,0,0,1053561,124411,1177972,2018
7,19977,UA,UA,United Air Lines Inc.,3,160016487,77508590,54291137,33340918,165140645,325157132,160622317,165858940,326481257,345244327,167717577,118654194,75241918,361613689,706858016,346587636,363233047,709820683,2018
7,20195,WI,WI,Sky Lease Cargo,1,0,0,0,0,0,0,0,1795795,1795795,0,0,0,0,0,0,0,4291515,4291515,2018
7,20310,WL,WL,"Caribbean Sun Airlines, Inc. d/b/a World Atlantic Airlines",1,0,0,0,0,0,0,76358,210120,286478,0,0,0,0,0,0,220912,607901,828813,2018
7,20377,X9,X9,Omni Air International LLC,2,0,0,0,0,0,0,510444,3385310,3895754,0,0,0,0,0,0,1387783,9529915,10917698,2018
7,20207,XP,XP,XTRA Airways,1,0,0,0,0,0,0,0,0,0,0,0,0,0,0,0,0,0,0,2018
7,20378,YV,YV,Mesa Airlines Inc.,2,0,0,0,0,0,0,0,0,0,0,0,0,0,0,0,0,0,0,2018
7,20452,YX,YX,Republic Airline,2,28582,0,0,0,0,28582,28582,0,28582,71869,0,0,0,0,71869,71869,0,71869,2018
7,19393,WN,WN,Southwest Airlines Co.,3,188793142,0,0,3010578,3010578,191803720,189080213,3010578,192090791,401007391,0,0,7786048,7786048,408793439,401635906,7786048,409421954,2018
8,21161,09Q,09Q,"Swift Air, LLC d/b/a Eastern Air Lines d/b/a Eastern",1,0,0,0,0,0,0,289139,753806,1042945,0,0,0,0,0,0,862612,2188316,3050928,2018
8,21352,0WQ,0WQ,Avjet Corporation,1,0,0,0,0,0,0,0,0,0,0,0,0,0,0,0,0,0,0,2018
8,21492,1BQ,1BQ,"Eastern Airlines f/k/a Dynamic Airways, LLC",1,0,0,0,0,0,0,9532,69349,78881,0,0,0,0,0,0,43075,268521,311596,2018
8,21652,27Q,27Q,"Jet Aviation Flight Services, Inc.",1,0,0,0,0,0,0,0,0,0,0,0,0,0,0,0,0,0,0,2018
8,21712,2HQ,2HQ,Elite Airways LLC,1,165200,0,0,0,0,165200,210291,0,210291,729619,0,0,0,0,729619,911751,0,911751,2018
8,20408,5V,5V,Tatonduk Outfitters Limited d/b/a Everts Air Alaska and Everts Air Cargo,1,394045,0,0,0,0,394045,461062,0,461062,1106293,0,0,0,0,1106293,1294445,0,1294445,2018
8,19917,5X,5X,United Parcel Service,3,41757000,11694000,18440000,2970000,33104000,74861000,41757000,33104000,74861000,91025000,25319000,40439000,6869000,72627000,163652000,91025000,72627000,163652000,2018
8,20007,5Y,5Y,Atlas Air Inc.,3,0,0,0,0,0,0,11774610,34316652,46091262,0,0,0,0,0,0,25361960,75930165,101292125,2018
8,19874,8C,8C,Air Transport International,2,0,0,0,0,0,0,22370,525183,547553,0,0,0,0,0,0,68563,1336405,1404968,2018
8,20363,9E,9E,Endeavor Air Inc.,2,0,0,0,0,0,0,0,0,0,0,0,0,0,0,0,0,0,0,2018
8,20190,9S,9S,Southern Air Inc.,2,789736,2000263,3911499,3313,5915075,6704811,789736,5915075,6704811,1708163,5103180,8306155,7482,13416817,15124980,1708163,13416817,15124980,2018
8,19805,AA,AA,American Airlines Inc.,3,200031244,65854434,22786302,45700050,134340786,334372030,200453516,134484089,334937605,425451929,142983221,49435800,105148593,297567614,723019543,426346992,297885732,724232724,2018
8,20453,ABX,ABX,ABX Air Inc,2,179809,0,0,0,0,179809,179809,0,179809,435624,0,0,0,0,435624,435624,0,435624,2018
8,19930,AS,AS,Alaska Airlines Inc.,3,64214894,0,0,931332,931332,65146226,64273462,931332,65204794,151584995,0,0,2401809,2401809,153986804,151711520,2401809,154113329,2018
8,20409,B6,B6,JetBlue Airways,3,60372656,0,0,16345598,16345598,76718254,60372656,16345598,76718254,138981422,0,0,37628533,37628533,176609955,138981422,37628533,176609955,2018
8,21167,CP,CP,Compass Airlines,2,0,0,0,0,0,0,0,0,0,0,0,0,0,0,0,0,0,0,2018
8,19790,DL,DL,Delta Air Lines Inc.,3,200758995,84633994,33898461,24013626,142546081,343305076,202074912,142546081,344620993,437347815,184372771,73846842,52313008,310532621,747880436,441798512,310532621,752331133,2018
8,20366,EV,EV,ExpressJet Airlines Inc.,3,0,0,0,0,0,0,0,0,0,0,0,0,0,0,0,0,0,0,2018
8,20436,F9,F9,Frontier Airlines Inc.,3,21117843,0,0,1771975,1771975,22889818,21117843,1771975,22889818,44981532,0,0,3886707,3886707,48868239,44981532,3886707,48868239,2018
8,20107,FX,FX,Federal Express Corporation,3,61282483,13711913,21927293,2085876,37725082,99007565,62725341,38579860,101305201,132626000,29423000,47712000,5059000,82194000,214820000,135776180,84147673,219923853,2018
8,20368,G4,G4,Allegiant Air,3,15158239,0,0,0,0,15158239,15769266,99840,15869106,36287601,0,0,0,0,36287601,37803056,252290,38055346,2018
8,20500,G7,G7,GoJet Airlines LLC d/b/a United Express,2,0,0,0,0,0,0,0,0,0,0,0,0,0,0,0,0,0,0,2018
8,20166,GFQ,GFQ,Gulf And Caribbean Cargo,1,0,0,0,0,0,0,140272,129339,269611,0,0,0,0,0,0,387328,382027,769355,2018
8,20402,GL,GL,Miami Air International,2,0,0,0,0,0,0,155249,200214,355463,0,0,0,0,0,0,445174,574110,1019284,2018
8,19690,HA,HA,Hawaiian Airlines Inc.,3,16457431,0,8355950,0,8355950,24813381,16489483,8355950,24845433,35501737,0,18032604,0,18032604,53534341,35570146,18032604,53602750,2018
8,20370,KAQ,KAQ,Kalitta Air LLC,2,0,0,0,0,0,0,1602652,4406932,6009584,0,0,0,0,0,0,3981973,10784806,14766779,2018
8,21629,KD,KD,Western Global,1,0,0,0,0,0,0,1548015,1554785,3102800,0,0,0,0,0,0,3565142,3659753,7224895,2018
8,21634,KH,KH,Aloha Air Cargo,1,386511,0,0,0,0,386511,386511,0,386511,831665,0,0,0,0,831665,831665,0,831665,2018
8,20372,KLQ,KLQ,Kalitta Charters II,1,0,0,0,0,0,0,157944,46934,204878,0,0,0,0,0,0,466989,130922,597911,2018
8,20169,L2,L2,Lynden Air Cargo Airlines,1,111583,0,0,0,0,111583,262850,0,262850,310951,0,0,0,0,310951,741119,0,741119,2018
8,20151,M6,M6,Amerijet International,2,0,0,0,1298975,1298975,1298975,320665,1362482,1683147,0,0,0,3043017,3043017,3043017,751199,3191790,3942989,2018
8,20398,MQ,MQ,Envoy Air,3,0,0,0,0,0,0,0,0,0,0,0,0,0,0,0,0,0,0,2018
8,20405,N8,N8,National Air Cargo Group Inc d/ba National Airlines,1,0,0,0,0,0,0,33672,2036400,2070072,0,0,0,0,0,0,98208,5222902,5321110,2018
8,20108,NC,NC,Northern Air Cargo Inc.,1,437991,0,0,0,0,437991,529533,0,529533,1001334,0,0,0,0,1001334,1242216,0,1242216,2018
8,20416,NK,NK,Spirit Air Lines,3,35200711,0,0,3781250,3781250,38981961,35200711,3781250,38981961,82607134,0,0,8873634,8873634,91480768,82607134,8873634,91480768,2018
8,20397,OH,OH,PSA Airlines Inc.,2,0,0,0,0,0,0,0,0,0,0,0,0,0,0,0,0,0,0,2018
8,20304,OO,OO,SkyWest Airlines Inc.,3,8454586,0,0,0,0,8454586,8454586,0,8454586,21656034,0,0,0,0,21656034,21656034,0,21656034,2018
8,20177,PFQ,PFQ,Asia Pacific,1,0,0,0,0,0,0,0,415690,415690,0,0,0,0,0,0,0,1004461,1004461,2018
8,20100,PO,PO,Polar Air Cargo Airways,3,3105841,621247,12190617,0,12811864,15917705,3105841,12811864,15917705,6909454,1528001,26983891,0,28511892,35421346,6909454,28511892,35421346,2018
8,19687,QX,QX,Horizon Air,2,0,0,0,0,0,0,0,0,0,0,0,0,0,0,0,0,0,0,2018
8,20422,SY,SY,Sun Country Airlines d/b/a MN Airlines,2,4085545,0,0,424051,424051,4509596,4720254,495170,5215424,9527166,0,0,1086295,1086295,10613461,12251178,1263664,13514842,2018
8,20447,U7,U7,USA Jet Airlines Inc.,2,0,0,0,0,0,0,554402,42021,596423,0,0,0,0,0,0,1219795,160449,1380244,2018
8,19977,UA,UA,United Air Lines Inc.,3,159273291,75836175,53503498,28912077,158251750,317525041,160321024,158683197,319004221,344423320,164053458,117380657,65302471,346736586,691159906,346659053,347764669,694423722,2018
8,20195,WI,WI,Sky Lease Cargo,1,0,0,0,0,0,0,415469,2220480,2635949,0,0,0,0,0,0,1042116,5343909,6386025,2018
8,20310,WL,WL,"Caribbean Sun Airlines, Inc. d/b/a World Atlantic Airlines",1,0,0,0,0,0,0,28671,54791,83462,0,0,0,0,0,0,115217,220183,335400,2018
8,20377,X9,X9,Omni Air International LLC,2,0,0,0,0,0,0,334116,3299842,3633958,0,0,0,0,0,0,781623,7981324,8762947,2018
8,20207,XP,XP,XTRA Airways,1,0,0,0,0,0,0,0,0,0,0,0,0,0,0,0,0,0,0,2018
8,20378,YV,YV,Mesa Airlines Inc.,2,0,0,0,0,0,0,0,0,0,0,0,0,0,0,0,0,0,0,2018
8,20452,YX,YX,Republic Airline,2,32883,0,0,0,0,32883,32883,0,32883,82173,0,0,0,0,82173,82173,0,82173,2018
8,19393,WN,WN,Southwest Airlines Co.,3,177342030,0,0,1929501,1929501,179271531,177680219,1929501,179609720,384095562,0,0,4971658,4971658,389067220,384841985,4971658,389813643,2018
9,21161,09Q,09Q,"Swift Air, LLC d/b/a Eastern Air Lines d/b/a Eastern",1,0,0,0,0,0,0,1141860,854072,1995932,0,0,0,0,0,0,2120004,1723832,3843836,2018
9,21352,0WQ,0WQ,Avjet Corporation,1,0,0,0,0,0,0,0,0,0,0,0,0,0,0,0,0,0,0,2018
9,21492,1BQ,1BQ,"Eastern Airlines f/k/a Dynamic Airways, LLC",1,0,0,0,0,0,0,10249,56483,66732,0,0,0,0,0,0,91562,304827,396389,2018
9,21652,27Q,27Q,"Jet Aviation Flight Services, Inc.",1,0,0,0,0,0,0,0,0,0,0,0,0,0,0,0,0,0,0,2018
9,21712,2HQ,2HQ,Elite Airways LLC,1,98997,0,0,0,0,98997,162857,0,162857,593144,0,0,0,0,593144,853155,0,853155,2018
9,20408,5V,5V,Tatonduk Outfitters Limited d/b/a Everts Air Alaska and Everts Air Cargo,1,284667,0,0,0,0,284667,406542,0,406542,884242,0,0,0,0,884242,1262813,0,1262813,2018
9,19917,5X,5X,United Parcel Service,3,36434000,11501000,17103000,2831000,31435000,67869000,36434000,31435000,67869000,81793000,25335000,37941000,6697000,69973000,151766000,81793000,69973000,151766000,2018
9,20007,5Y,5Y,Atlas Air Inc.,3,0,0,0,0,0,0,12548493,33654302,46202795,0,0,0,0,0,0,28794801,75367122,104161923,2018
9,19874,8C,8C,Air Transport International,2,0,0,0,0,0,0,32073,530703,562776,0,0,0,0,0,0,120270,1400656,1520926,2018
9,20363,9E,9E,Endeavor Air Inc.,2,0,0,0,0,0,0,0,0,0,0,0,0,0,0,0,0,0,0,2018
9,20190,9S,9S,Southern Air Inc.,2,927800,2128228,4114075,0,6242303,7170103,927800,6242303,7170103,2151384,5162388,9185487,0,14347875,16499259,2151384,14347875,16499259,2018
9,19805,AA,AA,American Airlines Inc.,3,181028818,62601948,21646081,36416887,120664916,301693734,181531340,120782036,302313376,394119266,139087701,47649727,84268973,271006401,665125667,395202923,271291326,666494249,2018
9,20453,ABX,ABX,ABX Air Inc,2,160456,0,0,0,0,160456,160456,0,160456,423041,0,0,0,0,423041,423041,0,423041,2018
9,19930,AS,AS,Alaska Airlines Inc.,3,56391507,0,0,752169,752169,57143676,56481306,752169,57233475,137146554,0,0,2040984,2040984,139187538,137345335,2040984,139386319,2018
9,20409,B6,B6,JetBlue Airways,3,55137735,0,0,13625002,13625002,68762737,55146389,13625002,68771391,129343736,0,0,31961934,31961934,161305670,129367128,31961934,161329062,2018
9,21167,CP,CP,Compass Airlines,2,0,0,0,0,0,0,0,0,0,0,0,0,0,0,0,0,0,0,2018
9,19790,DL,DL,Delta Air Lines Inc.,3,168810136,73208446,30517023,19504711,123230180,292040316,170130440,123230180,293360620,376816470,163415237,68119824,43538241,275073302,651889772,380946080,275073302,656019382,2018
9,20366,EV,EV,ExpressJet Airlines Inc.,3,0,0,0,0,0,0,0,0,0,0,0,0,0,0,0,0,0,0,2018
9,20436,F9,F9,Frontier Airlines Inc.,3,19581384,0,0,1569291,1569291,21150675,19581384,1569291,21150675,42471425,0,0,3510460,3510460,45981885,42471425,3510460,45981885,2018
9,20107,FX,FX,Federal Express Corporation,3,55834580,13439454,21430456,1977353,36847263,92681843,57340440,37992915,95333355,124467000,30214000,47711000,4945000,82870000,207337000,127853324,85617000,213470324,2018
9,20368,G4,G4,Allegiant Air,3,10358662,0,0,0,0,10358662,11066373,130281,11196654,25449320,0,0,0,0,25449320,27334820,346699,27681519,2018
9,20500,G7,G7,GoJet Airlines LLC d/b/a United Express,2,0,0,0,0,0,0,0,0,0,0,0,0,0,0,0,0,0,0,2018
9,20166,GFQ,GFQ,Gulf And Caribbean Cargo,1,0,0,0,0,0,0,227770,125688,353458,0,0,0,0,0,0,652633,379411,1032044,2018
9,20402,GL,GL,Miami Air International,2,0,0,0,0,0,0,208522,65686,274208,0,0,0,0,0,0,623950,196549,820499,2018
9,19690,HA,HA,Hawaiian Airlines Inc.,3,15212903,0,7916843,0,7916843,23129746,15274510,7916843,23191353,33925995,0,17459901,0,17459901,51385896,34062218,17459901,51522119,2018
9,20370,KAQ,KAQ,Kalitta Air LLC,2,0,0,0,0,0,0,1864537,5080289,6944826,0,0,0,0,0,0,4341177,12642922,16984099,2018
9,21629,KD,KD,Western Global,1,0,0,0,0,0,0,1563108,871084,2434192,0,0,0,0,0,0,3662478,2099163,5761641,2018
9,21634,KH,KH,Aloha Air Cargo,1,363038,0,0,0,0,363038,363038,0,363038,811256,0,0,0,0,811256,811256,0,811256,2018
9,20372,KLQ,KLQ,Kalitta Charters II,1,0,0,0,0,0,0,151052,71643,222695,0,0,0,0,0,0,426572,202628,629200,2018
9,20169,L2,L2,Lynden Air Cargo Airlines,1,89554,0,0,0,0,89554,194394,0,194394,225372,0,0,0,0,225372,544894,0,544894,2018
9,20151,M6,M6,Amerijet International,2,0,0,0,1189820,1189820,1189820,341985,1273730,1615715,0,0,0,2833760,2833760,2833760,814496,3033606,3848102,2018
9,20398,MQ,MQ,Envoy Air,3,0,0,0,0,0,0,0,0,0,0,0,0,0,0,0,0,0,0,2018
9,20405,N8,N8,National Air Cargo Group Inc d/ba National Airlines,1,0,0,0,0,0,0,18155,984449,1002604,0,0,0,0,0,0,55154,3411462,3466616,2018
9,20108,NC,NC,Northern Air Cargo Inc.,1,394320,0,0,0,0,394320,471127,0,471127,945597,0,0,0,0,945597,1122097,0,1122097,2018
9,20416,NK,NK,Spirit Air Lines,3,29025055,0,0,2800663,2800663,31825718,29025055,2800663,31825718,69326601,0,0,6689409,6689409,76016010,69326601,6689409,76016010,2018
9,20397,OH,OH,PSA Airlines Inc.,2,0,0,0,0,0,0,0,0,0,0,0,0,0,0,0,0,0,0,2018
9,20304,OO,OO,SkyWest Airlines Inc.,3,8231728,0,0,0,0,8231728,8231728,0,8231728,21210772,0,0,0,0,21210772,21210772,0,21210772,2018
9,20177,PFQ,PFQ,Asia Pacific,1,0,0,0,0,0,0,0,346443,346443,0,0,0,0,0,0,0,843305,843305,2018
9,20100,PO,PO,Polar Air Cargo Airways,3,3298841,749335,12422803,0,13172138,16470979,3298841,13172138,16470979,7428716,1852269,27346648,0,29198917,36627633,7428716,29198917,36627633,2018
9,19687,QX,QX,Horizon Air,2,0,0,0,0,0,0,0,0,0,0,0,0,0,0,0,0,0,0,2018
9,20422,SY,SY,Sun Country Airlines d/b/a MN Airlines,2,2583697,0,0,95011,95011,2678708,3309735,132728,,6193801,0,0,247840,247840,6441641,9354414,355233,9709647,2018
9,20447,U7,U7,USA Jet Airlines Inc.,2,0,0,0,0,0,0,486522,40552,527074,0,0,0,0,0,0,1101340,153660,1255000,2018
9,19977,UA,UA,United Air Lines Inc.,3,141269610,72072743,49587966,20822947,142483656,283753266,142507092,142776452,285283544,313606314,159197498,110178721,48133920,317510139,631116453,316362926,318139121,634502047,2018
9,20195,WI,WI,Sky Lease Cargo,1,0,0,0,0,0,0,34634,2452709,2487343,0,0,0,0,0,0,92998,5999056,6092054,2018
9,20310,WL,WL,"Caribbean Sun Airlines, Inc. d/b/a World Atlantic Airlines",1,0,0,0,0,0,0,76358,210120,286478,0,0,0,0,0,0,11571,31840,43411,2018
9,20377,X9,X9,Omni Air International LLC,2,0,0,0,0,0,0,363727,3053501,3417228,0,0,0,0,0,0,914458,7505782,8420240,2018
9,20207,XP,XP,XTRA Airways,1,0,0,0,0,0,0,0,0,0,0,0,0,0,0,0,0,0,0,2018
9,20378,YV,YV,Mesa Airlines Inc.,2,0,0,0,0,0,0,0,0,0,0,0,0,0,0,0,0,0,0,2018
9,20452,YX,YX,Republic Airline,2,31165,0,0,0,0,31165,31165,0,31165,78760,0,0,0,0,78760,78760,0,78760,2018
9,19393,WN,WN,Southwest Airlines Co.,3,162637319,0,0,1341792,1341792,163979111,162847237,1341792,164189029,348297781,0,0,3591438,3591438,351889219,348776993,3591438,352368431,2018
10,21161,09Q,09Q,"Swift Air, LLC d/b/a Eastern Air Lines d/b/a Eastern",1,0,0,0,0,0,0,951656,804553,1756209,0,0,0,0,0,0,2778676,1610931,4389607,2018
10,21352,0WQ,0WQ,Avjet Corporation,1,0,0,0,0,0,0,0,0,0,0,0,0,0,0,0,0,0,0,2018
10,21492,1BQ,1BQ,"Eastern Airlines f/k/a Dynamic Airways, LLC",1,0,0,0,0,0,0,5273,69110,74383,0,0,0,0,0,0,24293,365753,390046,2018
10,21652,27Q,27Q,"Jet Aviation Flight Services, Inc.",1,0,0,0,0,0,0,0,0,0,0,0,0,0,0,0,0,0,0,2018
10,21712,2HQ,2HQ,Elite Airways LLC,1,92461,0,0,0,0,92461,192870,0,192870,617785,0,0,0,0,617785,1029978,0,1029978,2018
10,21974,3EQ,3EQ,"Scott Aviation, LLC  d/b/a  Silver Air",1,0,0,0,0,0,0,0,0,0,0,0,0,0,0,0,0,0,0,2018
10,20408,5V,5V,Tatonduk Outfitters Limited d/b/a Everts Air Alaska and Everts Air Cargo,1,283912,0,0,0,0,283912,412738,0,412738,901808,0,0,0,0,901808,1311006,0,1311006,2018
10,19917,5X,5X,United Parcel Service,3,42096000,12627000,17864000,3091000,33582000,75678000,42096000,33582000,75678000,98401000,29228000,41558000,7528000,78314000,176715000,98401000,78314000,176715000,2018
10,20007,5Y,5Y,Atlas Air Inc.,3,0,0,0,0,0,0,14418638,34318954,48737592,0,0,0,0,0,0,33399942,79754517,113154459,2018
10,19874,8C,8C,Air Transport International,2,0,0,0,0,0,0,52155,798449,850604,0,0,0,0,0,0,172086,2132408,2304494,2018
10,20363,9E,9E,Endeavor Air Inc.,2,0,0,0,0,0,0,0,0,0,0,0,0,0,0,0,0,0,0,2018
10,20190,9S,9S,Southern Air Inc.,2,1277479,2587340,4489621,0,7076961,8354440,1277479,7076961,8354440,3004637,6819382,10343645,0,17163027,20167664,3004637,17163027,20167664,2018
10,19805,AA,AA,American Airlines Inc.,3,190202031,57757546,21654872,39482119,118894537,309096568,190720066,119106263,309826329,429957231,133999533,49571359,94049599,277620491,707577722,431121618,278144436,709266054,2018
10,20453,ABX,ABX,ABX Air Inc,2,148940,0,0,0,0,148940,148940,0,148940,408096,0,0,0,0,408096,408096,0,408096,2018
10,19930,AS,AS,Alaska Airlines Inc.,3,58513201,0,0,935097,935097,59448298,58606470,935097,59541567,148456459,0,0,2720459,2720459,151176918,148672193,2720459,151392652,2018
10,20409,B6,B6,JetBlue Airways,3,56242646,0,0,12988246,12988246,69230892,56269870,12988246,69258116,137757775,0,0,31812726,31812726,169570501,137819798,31812726,169632524,2018
10,21167,CP,CP,Compass Airlines,2,0,0,0,0,0,0,0,0,0,0,0,0,0,0,0,0,0,0,2018
10,19790,DL,DL,Delta Air Lines Inc.,3,175617975,65797081,28483623,20307172,114587876,290205851,177956053,114942532,292898585,428203416,160430814,69450661,49514297,279395772,707599188,435327025,280260519,715587544,2018
10,20366,EV,EV,ExpressJet Airlines Inc.,3,0,0,0,0,0,0,0,0,0,0,0,0,0,0,0,0,0,0,2018
10,20436,F9,F9,Frontier Airlines Inc.,3,20283982,0,0,1532727,1532727,21816709,20283982,1532727,21816709,46521713,0,0,3538851,3538851,50060564,46521713,3538851,50060564,2018
10,20107,FX,FX,Federal Express Corporation,3,61023312,14390935,22757187,2096417,39244539,100267851,62919596,40212734,103132330,141954000,34086000,52684000,5313000,92083000,234037000,146415000,94435000,240850000,2018
10,20368,G4,G4,Allegiant Air,3,13946435,0,0,0,0,13946435,14585655,126136,14711791,35643562,0,0,0,0,35643562,37359514,353980,37713494,2018
10,20500,G7,G7,GoJet Airlines LLC d/b/a United Express,2,0,0,0,0,0,0,0,0,0,0,0,0,0,0,0,0,0,0,2018
10,20166,GFQ,GFQ,Gulf And Caribbean Cargo,1,0,0,0,0,0,0,230150,147538,377688,0,0,0,0,0,0,651048,443018,1094066,2018
10,20402,GL,GL,Miami Air International,2,0,0,0,0,0,0,245771,153201,398972,0,0,0,0,0,0,776529,484049,1260578,2018
10,19690,HA,HA,Hawaiian Airlines Inc.,3,15613448,0,7176999,0,7176999,22790447,15666335,7176999,22843334,36610120,0,16614997,0,16614997,53225117,36735660,16614997,53350657,2018
10,20370,KAQ,KAQ,Kalitta Air LLC,2,0,0,0,0,0,0,2008223,5982453,7990676,0,0,0,0,0,0,5054631,15453768,20508399,2018
10,21629,KD,KD,Western Global,1,0,0,0,0,0,0,2018599,1336563,3355162,0,0,0,0,0,0,5064207,3337817,8402024,2018
10,21634,KH,KH,Aloha Air Cargo,1,380174,0,0,0,0,380174,380174,0,380174,822598,0,0,0,0,822598,822598,0,822598,2018
10,20372,KLQ,KLQ,Kalitta Charters II,1,0,0,0,0,0,0,226015,67274,293289,0,0,0,0,0,0,650605,195211,845816,2018
10,20169,L2,L2,Lynden Air Cargo Airlines,1,95018,0,0,0,0,95018,183110,0,183110,244223,0,0,0,0,244223,514050,0,514050,2018
10,20151,M6,M6,Amerijet International,2,0,0,0,1331890,1331890,1331890,335194,1427980,1763174,0,0,0,3324343,3324343,3324343,836631,3564180,4400811,2018
10,20398,MQ,MQ,Envoy Air,3,0,0,0,0,0,0,0,0,0,0,0,0,0,0,0,0,0,0,2018
10,20405,N8,N8,National Air Cargo Group Inc d/ba National Airlines,1,0,0,0,0,0,0,35808,878454,914262,0,0,0,0,0,0,217817,3011462,3229279,2018
10,20108,NC,NC,Northern Air Cargo Inc.,1,401400,0,0,0,0,401400,447821,0,447821,1030115,0,0,0,0,1030115,1141217,0,1141217,2018
10,20416,NK,NK,Spirit Air Lines,3,28643322,0,0,3076857,3076857,31720179,28643322,3076857,31720179,71707595,0,0,7702809,7702809,79410404,71707595,7702809,79410404,2018
10,20397,OH,OH,PSA Airlines Inc.,2,0,0,0,0,0,0,0,0,0,0,0,0,0,0,0,0,0,0,2018
10,20304,OO,OO,SkyWest Airlines Inc.,3,8642187,0,0,0,0,8642187,8642187,0,8642187,23651438,0,0,0,0,23651438,23651438,0,23651438,2018
10,20177,PFQ,PFQ,Asia Pacific,1,0,0,0,0,0,0,0,363731,363731,0,0,0,0,0,0,0,938097,938097,2018
10,20100,PO,PO,Polar Air Cargo Airways,3,3068527,754136,12587630,0,13341766,16410293,3068527,13341766,16410293,7273755,1923817,27563454,0,29487271,36761026,7273755,29487271,36761026,2018
10,19687,QX,QX,Horizon Air,2,0,0,0,0,0,0,0,0,0,0,0,0,0,0,0,0,0,0,2018
10,20422,SY,SY,Sun Country Airlines d/b/a MN Airlines,2,3370039,0,0,159654,159654,3529693,3910086,243070,,8366853,0,0,422069,422069,8788922,11395239,661534,12056773,2018
10,20447,U7,U7,USA Jet Airlines Inc.,2,0,0,0,0,0,0,740406,37962,778368,0,0,0,0,0,0,1741776,134239,1876015,2018
10,19977,UA,UA,United Air Lines Inc.,3,148705915,69162069,53152792,23637495,145952356,294658271,149747679,146120837,295868516,343661677,159995468,123497735,56781862,340275065,683936742,346072250,340674562,686746812,2018
10,20195,WI,WI,Sky Lease Cargo,1,0,0,0,0,0,0,53201,801354,854555,0,0,0,0,0,0,136425,2010878,2147303,2018
10,20310,WL,WL,"Caribbean Sun Airlines, Inc. d/b/a World Atlantic Airlines",1,0,0,0,0,0,0,35612,0,35612,0,0,0,0,0,0,170331,0,170331,2018
10,20377,X9,X9,Omni Air International LLC,2,0,0,0,0,0,0,356543,4680212,5036755,0,0,0,0,0,0,876748,11231246,12107994,2018
10,20378,YV,YV,Mesa Airlines Inc.,2,0,0,0,0,0,0,0,0,0,0,0,0,0,0,0,0,0,0,2018
10,20452,YX,YX,Republic Airline,2,27692,0,0,0,0,27692,27692,0,27692,72538,0,0,0,0,72538,72538,0,72538,2018
10,19393,WN,WN,Southwest Airlines Co.,3,175167101,0,0,1525109,1525109,176692210,175403853,1525109,176928962,385415886,0,0,4290762,4290762,389706648,385961453,4290762,390252215,2018
11,21161,09Q,09Q,"Swift Air, LLC d/b/a Eastern Air Lines d/b/a Eastern",1,0,0,0,0,0,0,1109693,823933,1933626,0,0,0,0,0,0,3114645,1692080,4806725,2018
11,21352,0WQ,0WQ,Avjet Corporation,1,0,0,0,0,0,0,0,0,0,0,0,0,0,0,0,0,0,0,2018
11,21492,1BQ,1BQ,"Eastern Airlines f/k/a Dynamic Airways, LLC",1,0,0,0,0,0,0,3006,97894,100900,0,0,0,0,0,0,12893,410447,423340,2018
11,21652,27Q,27Q,"Jet Aviation Flight Services, Inc.",1,0,0,0,0,0,0,0,0,0,0,0,0,0,0,0,0,0,0,2018
11,21712,2HQ,2HQ,Elite Airways LLC,1,92366,0,0,0,0,92366,342974,0,342974,601606,0,0,0,0,601606,1634542,0,1634542,2018
11,21974,3EQ,3EQ,"Scott Aviation, LLC  d/b/a  Silver Air",1,0,0,0,0,0,0,0,0,0,0,0,0,0,0,0,0,0,0,2018
11,20408,5V,5V,Tatonduk Outfitters Limited d/b/a Everts Air Alaska and Everts Air Cargo,1,276486,0,0,0,0,276486,350202,0,350202,824378,0,0,0,0,824378,1044172,0,1044172,2018
11,19917,5X,5X,United Parcel Service,3,43981000,12691000,18878000,2891000,34460000,78441000,43981000,34460000,78441000,85090000,24986000,38802000,6228000,70016000,155106000,85090000,70016000,155106000,2018
11,20007,5Y,5Y,Atlas Air Inc.,3,0,0,0,0,0,0,16624565,34004960,50629525,0,0,0,0,0,0,36947251,83968217,120915468,2018
11,19874,8C,8C,Air Transport International,2,0,0,0,0,0,0,22085,772245,794330,0,0,0,0,0,0,90412,2058532,2148944,2018
11,20363,9E,9E,Endeavor Air Inc.,2,0,0,0,0,0,0,0,0,0,0,0,0,0,0,0,0,0,0,2018
11,20190,9S,9S,Southern Air Inc.,2,1277479,2587340,4489621,0,7076961,8354440,1277479,7076961,8354440,3004637,6819382,10343645,0,17163027,20167664,3004637,17163027,20167664,2018
11,19805,AA,AA,American Airlines Inc.,3,178278460,35663616,20467960,40184086,96315662,274594122,178774406,96435227,275209633,381041941,78227639,45705316,92186994,216119949,597161890,382093421,216400743,598494164,2018
11,20453,ABX,ABX,ABX Air Inc,2,303415,0,0,0,0,303415,303415,0,303415,676615,0,0,0,0,676615,676615,0,676615,2018
11,19930,AS,AS,Alaska Airlines Inc.,3,56872621,0,0,1161601,1161601,58034222,56957076,1161601,58118677,138539021,0,0,3226627,3226627,141765648,138728248,3226627,141954875,2018
11,20409,B6,B6,JetBlue Airways,3,55670522,0,0,13234946,13234946,68905468,55678447,13234946,68913393,127924013,0,0,30412278,30412278,158336291,127942795,30412278,158355073,2018
11,21167,CP,CP,Compass Airlines,2,0,0,0,0,0,0,0,0,0,0,0,0,0,0,0,0,0,0,2018
11,19790,DL,DL,Delta Air Lines Inc.,3,166544649,46264522,27655626,20185262,94105410,260650059,168745755,94572449,263318204,409718189,113815823,68035887,49657968,231509678,641227867,416274199,232658645,648932844,2018
11,20366,EV,EV,ExpressJet Airlines Inc.,3,0,0,0,0,0,0,0,0,0,0,0,0,0,0,0,0,0,0,2018
11,20436,F9,F9,Frontier Airlines Inc.,3,19449100,0,0,1864227,1864227,21313327,19451155,1864227,21315382,41269934,0,0,4080427,4080427,45350361,41275319,4080427,45355746,2018
11,20107,FX,FX,Federal Express Corporation,3,62238017,13942269,23772721,1902563,39617553,101855570,64268198,41155806,105424004,132476000,30846000,55213000,4662000,90721000,223197000,136861329,94351000,231212329,2018
11,20368,G4,G4,Allegiant Air,3,14198071,0,0,0,0,14198071,14879759,99129,14978888,33851096,0,0,0,0,33851096,35624483,271778,35896261,2018
11,20500,G7,G7,GoJet Airlines LLC d/b/a United Express,2,0,0,0,0,0,0,0,0,0,0,0,0,0,0,0,0,0,0,2018
11,20166,GFQ,GFQ,Gulf And Caribbean Cargo,1,0,0,0,0,0,0,148983,169738,318721,0,0,0,0,0,0,409030,501656,910686,2018
11,20402,GL,GL,Miami Air International,2,0,0,0,0,0,0,407609,137232,544841,0,0,0,0,0,0,1187394,399763,1587157,2018
12,20007,5Y,5Y,Atlas Air Inc.,3,0,0,0,0,0,0,17838218,29388348,47226566,0,0,0,0,0,0,34617460,65367845,99985305,2018
11,19690,HA,HA,Hawaiian Airlines Inc.,3,15081782,0,6608270,0,6608270,21690052,15150640,6608270,21758910,32866803,0,14844238,0,14844238,47711041,33017337,14844238,47861575,2018
11,20370,KAQ,KAQ,Kalitta Air LLC,2,0,0,0,0,0,0,2782916,5845128,8628044,0,0,0,0,0,0,6228556,15806816,22035372,2018
11,21629,KD,KD,Western Global,1,0,0,0,0,0,0,1991715,2411691,4403406,0,0,0,0,0,0,4676523,2582242,7258765,2018
11,21634,KH,KH,Aloha Air Cargo,1,404924,0,0,0,0,404924,404924,0,404924,880716,0,0,0,0,880716,880716,0,880716,2018
11,20372,KLQ,KLQ,Kalitta Charters II,1,0,0,0,0,0,0,150186,208479,358665,0,0,0,0,0,0,420767,594841,1015608,2018
11,20169,L2,L2,Lynden Air Cargo Airlines,1,115551,0,0,0,0,115551,258151,0,258151,285963,0,0,0,0,285963,681279,0,681279,2018
11,20151,M6,M6,Amerijet International,2,0,0,0,1485989,1485989,1485989,335269,1571407,1906676,0,0,0,3431936,3431936,3431936,774314,3629211,4403525,2018
11,20398,MQ,MQ,Envoy Air,3,0,0,0,0,0,0,0,0,0,0,0,0,0,0,0,0,0,0,2018
11,20405,N8,N8,National Air Cargo Group Inc d/ba National Airlines,1,0,0,0,0,0,0,34487,209061,243548,0,0,0,0,0,0,131472,1144958,1276430,2018
11,20108,NC,NC,Northern Air Cargo Inc.,1,354064,0,0,0,0,354064,389857,0,389857,849184,0,0,0,0,849184,932350,0,932350,2018
11,20416,NK,NK,Spirit Air Lines,3,30177938,0,0,3806226,3806226,33984164,30177938,3806226,33984164,69626989,0,0,8781782,8781782,78408771,69626989,8781782,78408771,2018
11,20397,OH,OH,PSA Airlines Inc.,2,0,0,0,0,0,0,0,0,0,0,0,0,0,0,0,0,0,0,2018
11,20304,OO,OO,SkyWest Airlines Inc.,3,8304103,0,0,0,0,8304103,8304103,0,8304103,21469081,0,0,0,0,21469081,21469081,0,21469081,2018
11,20177,PFQ,PFQ,Asia Pacific,1,0,0,0,0,0,0,0,377504,377504,0,0,0,0,0,0,0,942917,942917,2018
11,20100,PO,PO,Polar Air Cargo Airways,3,3062327,720572,13181108,0,13901680,16964007,3062327,13901680,16964007,6611955,1873198,29783259,0,31656457,38268412,6611955,31656457,38268412,2018
11,19687,QX,QX,Horizon Air,2,0,0,0,0,0,0,0,0,0,0,0,0,0,0,0,0,0,0,2018
11,20422,SY,SY,Sun Country Airlines d/b/a MN Airlines,2,3488848,0,0,181639,181639,3670487,4101620,265624,,8120933,0,0,442293,442293,8563226,11027545,674788,11702333,2018
11,20447,U7,U7,USA Jet Airlines Inc.,2,0,0,0,0,0,0,699444,60188,759632,0,0,0,0,0,0,1512597,217357,1729954,2018
11,19977,UA,UA,United Air Lines Inc.,3,137562940,54546724,53370698,26748257,134665679,272228619,138755009,135045450,273800459,304097370,121997544,124119300,63654648,309771492,613868862,306790501,310650314,617440815,2018
11,20195,WI,WI,Sky Lease Cargo,1,0,0,0,0,0,0,0,681000,681000,0,0,0,0,0,0,0,1610529,1610529,2018
11,20310,WL,WL,"Caribbean Sun Airlines, Inc. d/b/a World Atlantic Airlines",1,0,0,0,0,0,0,35268,14971,50239,0,0,0,0,0,0,60560,25707,86267,2018
11,20377,X9,X9,Omni Air International LLC,2,0,0,0,0,0,0,392543,3253879,3646422,0,0,0,0,0,0,1085813,8844473,9930286,2018
11,20207,XP,XP,XTRA Airways,1,0,0,0,0,0,0,1581,0,1581,0,0,0,0,0,0,4851,0,4851,2018
11,20378,YV,YV,Mesa Airlines Inc.,2,0,0,0,0,0,0,0,0,0,0,0,0,0,0,0,0,0,0,2018
11,20452,YX,YX,Republic Airline,2,37786,0,0,0,0,37786,37786,1931,39717,98033,0,0,0,0,98033,98033,10234,108267,2018
11,19393,WN,WN,Southwest Airlines Co.,3,172865241,0,0,2075971,2075971,174941212,173093144,2075971,175169115,386222982,0,0,5543278,5543278,391766260,386731333,5543278,392274611,2018
12,21161,09Q,09Q,"Swift Air, LLC d/b/a Eastern Air Lines d/b/a Eastern",1,0,0,0,0,0,0,568956,730538,1299494,0,0,0,0,0,0,2111233,2631018,4742251,2018
12,21352,0WQ,0WQ,Avjet Corporation,1,0,0,0,0,0,0,0,0,0,0,0,0,0,0,0,0,0,0,2018
12,21492,1BQ,1BQ,"Eastern Airlines f/k/a Dynamic Airways, LLC",1,0,0,0,0,0,0,81656,191011,272667,0,0,0,0,0,0,201690,471798,673488,2018
12,21652,27Q,27Q,"Jet Aviation Flight Services, Inc.",1,0,0,0,0,0,0,0,0,0,0,0,0,0,0,0,0,0,0,2018
12,21712,2HQ,2HQ,Elite Airways LLC,1,120149,0,0,0,0,120149,297468,0,297468,307035,0,0,0,0,307035,991585,0,991585,2018
12,21974,3EQ,3EQ,"Scott Aviation, LLC  d/b/a  Silver Air",1,0,0,0,0,0,0,0,0,0,0,0,0,0,0,0,0,0,0,2018
12,20408,5V,5V,Tatonduk Outfitters Limited d/b/a Everts Air Alaska and Everts Air Cargo,1,306461,0,0,0,0,306461,337373,0,337373,841332,0,0,0,0,841332,926195,0,926195,2018
12,19917,5X,5X,United Parcel Service,3,52377000,11580000,18592000,2623000,32795000,85172000,52377000,32795000,85172000,97938000,22943000,37725000,5257000,65925000,163863000,97938000,65925000,163863000,2018
12,19874,8C,8C,Air Transport International,2,0,0,0,0,0,0,33886,631780,665666,0,0,0,0,0,0,112137,1680754,1792891,2018
12,20363,9E,9E,Endeavor Air Inc.,2,0,0,0,0,0,0,0,0,0,0,0,0,0,0,0,0,0,0,2018
12,20190,9S,9S,Southern Air Inc.,2,1082193,2347642,4036823,0,6384465,7466658,1082193,6384465,7466658,2077709,5598636,8756152,0,14354788,16432497,2077709,14354788,16432497,2018
12,19805,AA,AA,American Airlines Inc.,3,183225048,39666096,20612267,47518703,107797066,291022114,183950477,108065723,292016200,345960844,75797308,40400670,97609584,213807562,559768406,347350008,214357788,561707796,2018
12,20453,ABX,ABX,ABX Air Inc,2,157837,0,0,0,0,157837,157837,0,157837,326406,0,0,0,0,326406,326406,0,326406,2018
12,19930,AS,AS,Alaska Airlines Inc.,3,58351163,0,0,1247068,1247068,59598231,58393891,1247068,59640959,124274679,0,0,2981090,2981090,127255769,124358971,2981090,127340061,2018
12,20409,B6,B6,JetBlue Airways,3,58371808,0,0,15760954,15760954,74132762,58371808,15760954,74132762,116905050,0,0,31565497,31565497,148470547,116905050,31565497,148470547,2018
12,21167,CP,CP,Compass Airlines,2,0,0,0,0,0,0,0,0,0,0,0,0,0,0,0,0,0,0,2018
12,19790,DL,DL,Delta Air Lines Inc.,3,169260696,49938304,28205026,26005274,104148604,273409300,171295959,104193282,275489241,414326853,122242084,69042016,63657326,254941426,669268279,420310062,255050793,675360855,2018
12,20366,EV,EV,ExpressJet Airlines Inc.,3,0,0,0,0,0,0,0,0,0,0,0,0,0,0,0,0,0,0,2018
12,20436,F9,F9,Frontier Airlines Inc.,3,20060908,0,0,2134220,2134220,22195128,20060908,2134220,22195128,34763616,0,0,3889954,3889954,38653570,34763616,3889954,38653570,2018
12,20107,FX,FX,Federal Express Corporation,3,68804108,12786072,23693428,1615229,38094729,106898837,70985605,39271361,110256966,125678000,24375000,48133000,3701000,76209000,201887000,129749323,78962000,208711323,2018
12,20368,G4,G4,Allegiant Air,3,14201521,0,0,0,0,14201521,14498951,109719,14608670,29156374,0,0,0,0,29156374,29816595,258352,30074947,2018
12,20500,G7,G7,GoJet Airlines LLC d/b/a United Express,2,0,0,0,0,0,0,0,0,0,0,0,0,0,0,0,0,0,0,2018
12,20166,GFQ,GFQ,Gulf And Caribbean Cargo,1,0,0,0,0,0,0,129999,94093,224092,0,0,0,0,0,0,336424,253845,590269,2018
12,20402,GL,GL,Miami Air International,2,0,0,0,0,0,0,443923,136206,580129,0,0,0,0,0,0,1278214,392186,1670400,2018
12,19690,HA,HA,Hawaiian Airlines Inc.,3,15929254,0,7181169,0,7181169,23110423,15967302,7181169,23148471,29553404,0,13821733,0,13821733,43375137,29626540,13821733,43448273,2018
12,20370,KAQ,KAQ,Kalitta Air LLC,2,0,0,0,0,0,0,3765261,3114953,6880214,0,0,0,0,0,0,7028046,6821090,13849136,2018
12,21629,KD,KD,Western Global,1,0,0,0,0,0,0,1522627,669524,2192151,0,0,0,0,0,0,2964857,1442526,4407383,2018
12,21634,KH,KH,Aloha Air Cargo,1,478286,0,0,0,0,478286,478286,0,478286,880599,0,0,0,0,880599,880599,0,880599,2018
12,20372,KLQ,KLQ,Kalitta Charters II,1,0,0,0,0,0,0,113975,53156,167131,0,0,0,0,0,0,270419,139182,409601,2018
12,20169,L2,L2,Lynden Air Cargo Airlines,1,106261,0,0,0,0,106261,219581,0,219581,230050,0,0,0,0,230050,538326,0,538326,2018
12,20151,M6,M6,Amerijet International,2,0,0,0,830871,830871,830871,699790,1320662,2020452,0,0,0,1673761,1673761,1673761,1409703,2660428,4070131,2018
12,20398,MQ,MQ,Envoy Air,3,0,0,0,0,0,0,0,0,0,0,0,0,0,0,0,0,0,0,2018
12,20405,N8,N8,National Air Cargo Group Inc d/ba National Airlines,1,0,0,0,0,0,0,19529,30173,49702,0,0,0,0,0,0,78036,1068551,1146587,2018
12,20108,NC,NC,Northern Air Cargo Inc.,1,347640,0,0,0,0,347640,401947,0,401947,711359,0,0,0,0,711359,826432,0,826432,2018
12,20416,NK,NK,Spirit Air Lines,3,31404327,0,0,4486332,4486332,35890659,31404327,4486332,35890659,62878234,0,0,8982605,8982605,71860839,62878234,8982605,71860839,2018
12,20397,OH,OH,PSA Airlines Inc.,2,0,0,0,0,0,0,0,0,0,0,0,0,0,0,0,0,0,0,2018
12,20304,OO,OO,SkyWest Airlines Inc.,3,8477821,0,0,0,0,8477821,8477821,0,8477821,19095798,0,0,0,0,19095798,19095798,0,19095798,2018
12,20177,PFQ,PFQ,Asia Pacific,1,0,0,0,0,0,0,0,460223,460223,0,0,0,0,0,0,0,1075300,1075300,2018
12,20100,PO,PO,Polar Air Cargo Airways,3,3234784,733771,13255025,0,13988796,17223580,3234784,13988796,17223580,5906247,1737593,26195654,0,27933247,33839494,5906247,27933247,33839494,2018
12,19687,QX,QX,Horizon Air,2,0,0,0,0,0,0,0,0,0,0,0,0,0,0,0,0,0,0,2018
12,20422,SY,SY,Sun Country Airlines d/b/a MN Airlines,2,4308507,0,0,677633,677633,4986140,4820011,711214,,8713955,0,0,1406377,1406377,10120332,10234950,1492741,11727691,2018
12,20447,U7,U7,USA Jet Airlines Inc.,2,0,0,0,0,0,0,648588,30112,678700,0,0,0,0,0,0,1214526,121050,1335576,2018
12,19977,UA,UA,United Air Lines Inc.,3,142854724,56029877,55780672,32776274,144586823,287441547,143930940,144825950,288756890,275410791,109397007,113811159,68269995,291478161,566888952,277512225,291961751,569473976,2018
12,20195,WI,WI,Sky Lease Cargo,1,0,0,0,0,0,0,267465,521082,788547,0,0,0,0,0,0,701552,1091983,1793535,2018
12,20310,WL,WL,"Caribbean Sun Airlines, Inc. d/b/a World Atlantic Airlines",1,0,0,0,0,0,0,64970,0,64970,0,0,0,0,0,0,168103,0,168103,2018
12,20377,X9,X9,Omni Air International LLC,2,0,0,0,0,0,0,632636,1899102,2531738,0,0,0,0,0,0,1584314,4588387,6172701,2018
12,20207,XP,XP,XTRA Airways,1,0,0,0,0,0,0,0,0,0,0,0,0,0,0,0,0,0,0,2018
12,20378,YV,YV,Mesa Airlines Inc.,2,0,0,0,0,0,0,0,0,0,0,0,0,0,0,0,0,0,0,2018
12,20452,YX,YX,Republic Airline,2,21048,0,0,0,0,21048,21048,0,21048,50043,0,0,0,0,50043,50043,0,50043,2018
12,19393,WN,WN,Southwest Airlines Co.,3,173203901,0,0,2440902,2440902,175644803,173448291,2440902,175889193,351339537,0,0,5730304,5730304,357069841,351820604,5730304,357550908,2018
